corp_id,corp_name,in_stlmt_tot,res_nrl,public_xfr_in,public_xfr_out,net_pub_xfr,xfr_ch_schlsp_out,net_xfr,xfr_out_tot,xfr_out_tot_rate,xfr_in_rate,pr_xfr_out_rate,net_xfr_rate,yr
0015,Adams Central Community Schools,1019,933,352,73,279,13,266,86,8,35,1,26,2023-08-01
0025,North Adams Community Schools,2051,1461,99,380,-281,210,-491,590,29,5,10,-24,2023-08-01
0035,South Adams Schools,1288,1200,69,85,-16,3,-19,88,7,5,0,-1,2023-08-01
0125,MSD Southwest Allen County Schls,8308,7629,108,184,-76,495,-571,679,8,1,6,-7,2023-08-01
0225,Northwest Allen County Schools,8881,8071,66,306,-240,504,-744,810,9,1,6,-8,2023-08-01
0235,Fort Wayne Community Schools,35236,27537,25,2540,-2515,5159,-7674,7699,22,0,15,-22,2023-08-01
0255,East Allen County Schools,11171,9044,914,603,311,1524,-1213,2127,19,8,14,-11,2023-08-01
0365,Bartholomew Con School Corp,12281,11086,330,437,-107,758,-865,1195,10,3,6,-7,2023-08-01
0370,Flat Rock-Hawcreek School Corp,848,749,213,84,129,15,114,99,12,25,2,13,2023-08-01
0395,Benton Community School Corp,1780,1537,56,146,-90,97,-187,243,14,3,5,-11,2023-08-01
0515,Blackford County Schools,1752,1446,49,305,-256,1,-257,306,17,3,0,-15,2023-08-01
0615,Western Boone Co Com Sch Dist,1484,1359,230,110,120,15,105,125,8,15,1,7,2023-08-01
0630,Zionsville Community Schools,7778,7580,71,115,-44,83,-127,198,3,1,1,-2,2023-08-01
0665,Lebanon Community School Corp,3775,3355,96,335,-239,85,-324,420,11,3,2,-9,2023-08-01
0670,Brown County School Corporation,1810,1501,52,282,-230,27,-257,309,17,3,1,-14,2023-08-01
0750,Carroll Consolidated School Corp,1101,953,83,136,-53,12,-65,148,13,8,1,-6,2023-08-01
0755,Delphi Community School Corp,1405,1259,102,127,-25,19,-44,146,10,7,1,-3,2023-08-01
0775,Pioneer Regional School Corp,973,889,22,84,-62,0,-62,84,9,2,0,-6,2023-08-01
0815,Lewis Cass Schools,1305,1084,244,219,25,2,23,221,17,19,0,2,2023-08-01
0875,Logansport Community Sch Corp,4378,4131,172,244,-72,3,-75,247,6,4,0,-2,2023-08-01
0935,Borden-Henryville School Corp,2002,1412,253,516,-263,74,-337,590,29,13,4,-17,2023-08-01
0945,Silver Creek School Corporation,3127,2394,673,529,144,204,-60,733,23,22,7,-2,2023-08-01
1000,Clarksville Community School Corp,1413,960,2859,377,2482,76,2406,453,32,202,5,170,2023-08-01
1010,Greater Clark County Schools,11850,9609,404,1727,-1323,514,-1837,2241,19,3,4,-16,2023-08-01
1125,Clay Community Schools,3928,3702,250,220,30,6,24,226,6,6,0,1,2023-08-01
1150,Clinton Central School Corporation,840,688,177,146,31,6,25,152,18,21,1,3,2023-08-01
1160,Clinton Prairie School Corporation,1076,928,253,120,133,28,105,148,14,24,3,10,2023-08-01
1170,Community Schools of Frankfort,3409,2879,79,505,-426,25,-451,530,16,2,1,-13,2023-08-01
1180,Rossville Con School District,826,761,180,36,144,29,115,65,8,22,4,14,2023-08-01
1300,Crawford County Community Sch Corp,1534,1288,43,241,-198,5,-203,246,16,3,0,-13,2023-08-01
1315,Barr-Reeve Community Schools Inc,758,698,322,58,264,2,262,60,8,42,0,35,2023-08-01
1375,North Daviess Com Schools,1011,914,193,87,106,10,96,97,10,19,1,9,2023-08-01
1405,Washington Community Schools,3006,2434,15,379,-364,193,-557,572,19,0,6,-19,2023-08-01
1560,Sunman-Dearborn Com Sch Corp,4001,3496,276,357,-81,148,-229,505,13,7,4,-6,2023-08-01
1600,South Dearborn Community Sch Corp,2471,1813,133,540,-407,118,-525,658,27,5,5,-21,2023-08-01
1620,Lawrenceburg Community School Corp,1819,1647,445,127,318,45,273,172,9,24,2,15,2023-08-01
1655,Decatur County Community Schools,1853,1498,309,332,-23,23,-46,355,19,17,1,-2,2023-08-01
1730,Greensburg Community Schools,2174,1900,151,256,-105,18,-123,274,13,7,1,-6,2023-08-01
1805,DeKalb Co Eastern Com Sch Dist,1227,1083,195,126,69,18,51,144,12,16,1,4,2023-08-01
1820,Garrett-Keyser-Butler Com Sch Corp,1631,1425,266,142,124,64,60,206,13,16,4,4,2023-08-01
1835,DeKalb Co Ctl United Sch Dist,3855,3240,241,404,-163,211,-374,615,16,6,5,-10,2023-08-01
1875,Delaware Community School Corp,2626,2216,385,387,-2,23,-25,410,16,15,1,-1,2023-08-01
1885,Wes-Del Community Schools,727,585,251,128,123,14,109,142,20,35,2,15,2023-08-01
1895,Liberty-Perry Community Sch Corp,930,765,405,157,248,8,240,165,18,44,1,26,2023-08-01
1900,Cowan Community School Corp,528,414,382,108,274,6,268,114,22,72,1,51,2023-08-01
1910,Yorktown Community Schools,2409,2137,582,235,347,37,310,272,11,24,2,13,2023-08-01
1940,Daleville Community Schools,638,496,532,124,408,18,390,142,22,83,3,61,2023-08-01
1970,Muncie Community Schools,7194,4678,183,2370,-2187,146,-2333,2516,35,3,2,-32,2023-08-01
2040,Northeast Dubois Co Sch Corp,775,701,75,68,7,6,1,74,10,10,1,0,2023-08-01
2100,Southeast Dubois Co Sch Corp,1174,1097,112,75,37,2,35,77,7,10,0,3,2023-08-01
2110,Southwest Dubois Co Sch Corp,1808,1712,166,90,76,6,70,96,5,9,0,4,2023-08-01
2120,Greater Jasper Consolidated Schs,3327,3002,168,147,21,178,-157,325,10,5,5,-5,2023-08-01
2155,Fairfield Community Schools,2025,1819,350,179,171,27,144,206,10,17,1,7,2023-08-01
2260,Baugo Community Schools,1709,1490,303,166,137,53,84,219,13,18,3,5,2023-08-01
2270,Concord Community Schools,5102,4546,800,394,406,162,244,556,11,16,3,5,2023-08-01
2275,Middlebury Community Schools,4142,3739,525,316,209,87,122,403,10,13,2,3,2023-08-01
2285,Wa-Nee Community Schools,2851,2652,267,152,115,47,68,199,7,9,2,2,2023-08-01
2305,Elkhart Community Schools,13469,10929,261,1958,-1697,582,-2279,2540,19,2,4,-17,2023-08-01
2315,Goshen Community Schools,6705,5731,457,611,-154,363,-517,974,15,7,5,-8,2023-08-01
2395,Fayette County School Corporation,3333,2969,66,258,-192,106,-298,364,11,2,3,-9,2023-08-01
2400,New Albany-Floyd Co Con Sch,11910,10355,918,979,-61,576,-637,1555,13,8,5,-5,2023-08-01
2435,Attica Consolidated School Corp,558,490,38,63,-25,5,-30,68,12,7,1,-5,2023-08-01
2440,Covington Community School Corp,836,739,83,59,24,38,-14,97,12,10,5,-2,2023-08-01
2455,Southeast Fountain School Corp,1010,903,69,103,-34,4,-38,107,11,7,0,-4,2023-08-01
2475,Franklin County Community Sch Corp,2431,1994,38,288,-250,149,-399,437,18,2,6,-16,2023-08-01
2645,Rochester Community School Corp,1720,1421,118,299,-181,0,-181,299,17,7,0,-11,2023-08-01
2650,Caston School Corporation,750,631,201,119,82,0,82,119,16,27,0,11,2023-08-01
2725,East Gibson School Corporation,900,699,15,190,-175,11,-186,201,22,2,1,-21,2023-08-01
2735,North Gibson School Corporation,2080,1782,109,229,-120,69,-189,298,14,5,3,-9,2023-08-01
2765,South Gibson School Corporation,2076,1810,303,134,169,132,37,266,13,15,6,2,2023-08-01
2815,Eastbrook Community Sch Corp,1364,1207,386,128,258,29,229,157,12,28,2,17,2023-08-01
2825,Madison-Grant United School Corp,1223,971,520,216,304,36,268,252,21,43,3,22,2023-08-01
2855,Mississinewa Community School Corp,1726,1613,645,99,546,14,532,113,7,37,1,31,2023-08-01
2865,Marion Community Schools,5020,3401,65,1361,-1296,258,-1554,1619,32,1,5,-31,2023-08-01
2920,Bloomfield School District,942,787,37,155,-118,0,-118,155,16,4,0,-13,2023-08-01
2940,Eastern Greene Schools,1081,941,140,121,19,19,0,140,13,13,2,0,2023-08-01
2950,Linton-Stockton School Corporation,1262,1072,239,190,49,0,49,190,15,19,0,4,2023-08-01
2960,MSD Shakamak Schools,761,583,64,178,-114,0,-114,178,23,8,0,-15,2023-08-01
2980,White River Valley School District,788,600,114,188,-74,0,-74,188,24,14,0,-9,2023-08-01
3005,Hamilton Southeastern Schools,22531,21078,70,654,-584,799,-1383,1453,6,0,4,-6,2023-08-01
3025,Hamilton Heights School Corp,2022,1870,349,112,237,40,197,152,8,17,2,10,2023-08-01
3030,Westfield-Washington Schools,9482,9027,60,307,-247,148,-395,455,5,1,2,-4,2023-08-01
3055,Sheridan Community Schools,1024,937,151,70,81,17,64,87,8,15,2,6,2023-08-01
3060,Carmel Clay Schools,16248,15751,194,265,-71,232,-303,497,3,1,1,-2,2023-08-01
3070,Noblesville Schools,11305,10314,65,599,-534,392,-926,991,9,1,3,-8,2023-08-01
3115,Southern Hancock Co Com Sch Corp,3361,3075,667,189,478,97,381,286,9,20,3,11,2023-08-01
3125,Greenfield-Central Com Schools,4693,4028,254,551,-297,114,-411,665,14,5,2,-9,2023-08-01
3135,Mt Vernon Community School Corp,4541,3952,585,429,156,160,-4,589,13,13,4,-0,2023-08-01
3145,Eastern Hancock Co Com Sch Corp,901,783,386,110,276,8,268,118,13,43,1,30,2023-08-01
3160,Lanesville Community School Corp,640,501,249,106,143,33,110,139,22,39,5,17,2023-08-01
3180,North Harrison Com School Corp,2136,1774,305,318,-13,44,-57,362,17,14,2,-3,2023-08-01
3190,South Harrison Com Schools,3273,2814,189,357,-168,102,-270,459,14,6,3,-8,2023-08-01
3295,North West Hendricks Schools,1900,1725,187,100,87,75,12,175,9,10,4,1,2023-08-01
3305,Brownsburg Community School Corp,10441,9687,195,312,-117,442,-559,754,7,2,4,-5,2023-08-01
3315,Avon Community School Corp,11291,10204,145,581,-436,506,-942,1087,10,1,4,-8,2023-08-01
3325,Danville Community School Corp,2591,2346,239,190,49,55,-6,245,9,9,2,-0,2023-08-01
3330,Plainfield Community School Corp,5539,5146,534,301,233,92,141,393,7,10,2,3,2023-08-01
3335,Mill Creek Community Sch Corp,1565,1347,171,184,-13,34,-47,218,14,11,2,-3,2023-08-01
3405,Blue River Valley Schools,560,407,188,146,42,7,35,153,27,34,1,6,2023-08-01
3415,South Henry School Corp,627,497,255,127,128,3,125,130,21,41,0,20,2023-08-01
3435,Shenandoah School Corporation,1177,1026,283,136,147,15,132,151,13,24,1,11,2023-08-01
3445,New Castle Community School Corp,3226,2700,175,521,-346,5,-351,526,16,5,0,-11,2023-08-01
3455,C A Beard Memorial School Corp,1330,939,98,343,-245,48,-293,391,29,7,4,-22,2023-08-01
3460,Taylor Community School Corp,1338,776,494,529,-35,33,-68,562,42,37,2,-5,2023-08-01
3470,Northwestern School Corp,1481,1265,577,190,387,26,361,216,15,39,2,24,2023-08-01
3480,Eastern Howard School Corporation,1025,926,688,92,596,7,589,99,10,67,1,57,2023-08-01
3490,Western School Corporation,2294,1921,563,337,226,36,190,373,16,25,2,8,2023-08-01
3500,Kokomo School Corporation,6597,4512,269,1892,-1623,193,-1816,2085,32,4,3,-28,2023-08-01
3625,Huntington Co Com Sch Corp,5419,4769,89,473,-384,177,-561,650,12,2,3,-10,2023-08-01
3640,Medora Community School Corp,220,150,43,67,-24,3,-27,70,32,20,1,-12,2023-08-01
3675,Seymour Community Schools,5826,5133,192,217,-25,476,-501,693,12,3,8,-9,2023-08-01
3695,Brownstown Cnt Com Sch Corp,1563,1284,142,141,1,138,-137,279,18,9,9,-9,2023-08-01
3710,Crothersville Community Schools,492,373,47,91,-44,28,-72,119,24,10,6,-15,2023-08-01
3785,Kankakee Valley School Corp,3513,3094,114,165,-51,254,-305,419,12,3,7,-9,2023-08-01
3815,Rensselaer Central School Corp,1503,1359,85,109,-24,35,-59,144,10,6,2,-4,2023-08-01
3945,Jay School Corporation,3188,2826,88,235,-147,127,-274,362,11,3,4,-9,2023-08-01
3995,Madison Consolidated Schools,3335,2448,116,568,-452,319,-771,887,27,3,10,-23,2023-08-01
4000,Southwestern-Jefferson Co Con,1187,927,280,194,86,66,20,260,22,24,6,2,2023-08-01
4015,Jennings County School Corporation,4313,3733,123,323,-200,257,-457,580,13,3,6,-11,2023-08-01
4145,Clark-Pleasant Community Sch Corp,7680,6601,204,786,-582,293,-875,1079,14,3,4,-11,2023-08-01
4205,Center Grove Community School Corp,9840,8909,525,530,-5,401,-406,931,9,5,4,-4,2023-08-01
4215,Edinburgh Community School Corp,798,647,157,138,19,13,6,151,19,20,2,1,2023-08-01
4225,Franklin Community School Corp,5161,4526,345,509,-164,126,-290,635,12,7,2,-6,2023-08-01
4245,Greenwood Community Sch Corp,3695,3221,716,315,401,159,242,474,13,19,4,7,2023-08-01
4255,Nineveh-Hensley-Jackson United,1827,1622,450,161,289,44,245,205,11,25,2,13,2023-08-01
4315,North Knox School Corp,1410,1200,15,183,-168,27,-195,210,15,1,2,-14,2023-08-01
4325,South Knox School Corp,1079,968,283,79,204,32,172,111,10,26,3,16,2023-08-01
4335,Vincennes Community School Corp,3122,2676,121,302,-181,144,-325,446,14,4,5,-10,2023-08-01
4345,Wawasee Community School Corp,2875,2566,184,283,-99,26,-125,309,11,6,1,-4,2023-08-01
4415,Warsaw Community Schools,6966,6244,458,465,-7,257,-264,722,10,7,4,-4,2023-08-01
4445,Tippecanoe Valley School Corp,1788,1505,235,264,-29,19,-48,283,16,13,1,-3,2023-08-01
4455,Whitko Community School Corp,1451,1075,105,346,-241,30,-271,376,26,7,2,-19,2023-08-01
4515,Prairie Heights Community Sch Corp,1260,1074,254,180,74,6,68,186,15,20,0,5,2023-08-01
4525,Westview School Corporation,1854,1748,296,97,199,9,190,106,6,16,0,10,2023-08-01
4535,Lakeland School Corporation,1933,1542,56,386,-330,5,-335,391,20,3,0,-17,2023-08-01
4580,Hanover Community School Corp,2997,2678,21,78,-57,241,-298,319,11,1,8,-10,2023-08-01
4590,River Forest Community Sch Corp,1353,1232,368,79,289,42,247,121,9,27,3,18,2023-08-01
4600,Merrillville Community School Corp,6564,5739,51,367,-316,458,-774,825,13,1,7,-12,2023-08-01
4615,Lake Central School Corporation,9803,9044,50,252,-202,507,-709,759,8,1,5,-7,2023-08-01
4645,Tri-Creek School Corporation,3436,3194,88,111,-23,131,-154,242,7,3,4,-4,2023-08-01
4650,Lake Ridge New Tech Schools,1368,1166,475,100,375,102,273,202,15,35,7,20,2023-08-01
4660,Crown Point Community School Corp,9473,8861,11,206,-195,406,-601,612,6,0,4,-6,2023-08-01
4670,School City of East Chicago,4706,3113,64,1218,-1154,375,-1529,1593,34,1,8,-32,2023-08-01
4680,Lake Station Community Schools,1327,1010,134,223,-89,94,-183,317,24,10,7,-14,2023-08-01
4690,Gary Community School Corp,11386,3822,0,6972,-6972,592,-7564,7564,66,0,5,-66,2023-08-01
4700,Griffith Public Schools,2171,1876,67,155,-88,140,-228,295,14,3,6,-11,2023-08-01
4710,School City of Hammond,13108,10436,492,1513,-1021,1159,-2180,2672,20,4,9,-17,2023-08-01
4720,School Town of Highland,3253,2923,60,119,-59,211,-270,330,10,2,6,-8,2023-08-01
4730,School City of Hobart,4222,3945,25,177,-152,100,-252,277,7,1,2,-6,2023-08-01
4740,School Town of Munster,4065,3890,198,62,136,113,23,175,4,5,3,1,2023-08-01
4760,School City of Whiting,805,725,381,39,342,41,301,80,10,47,5,37,2023-08-01
4805,New Prairie United School Corp,2506,2347,634,144,490,15,475,159,6,25,1,19,2023-08-01
4860,MSD of New Durham Township,766,641,326,110,216,15,201,125,16,43,2,26,2023-08-01
4915,Tri-Township Cons School Corp,490,236,84,250,-166,4,-170,254,52,17,1,-35,2023-08-01
4925,Michigan City Area Schools,6175,4870,284,849,-565,456,-1021,1305,21,5,7,-17,2023-08-01
4940,South Central Com School Corp,689,594,371,82,289,13,276,95,14,54,2,40,2023-08-01
4945,LaPorte Community School Corp,6545,5571,240,839,-599,135,-734,974,15,4,2,-11,2023-08-01
5075,North Lawrence Com Schools,4652,3597,79,884,-805,171,-976,1055,23,2,4,-21,2023-08-01
5085,Mitchell Community Schools,1594,1317,148,271,-123,6,-129,277,17,9,0,-8,2023-08-01
5245,Frankton-Lapel Community Schools,2113,1986,984,94,890,33,857,127,6,47,2,41,2023-08-01
5255,South Madison Com Sch Corp,4130,3841,617,239,378,50,328,289,7,15,1,8,2023-08-01
5265,Alexandria Community School Corp,1507,1241,225,200,25,66,-41,266,18,15,4,-3,2023-08-01
5275,Anderson Community School Corp,9867,5961,25,3162,-3137,744,-3881,3906,40,0,8,-39,2023-08-01
5280,Elwood Community School Corp,1520,1267,202,239,-37,14,-51,253,17,13,1,-3,2023-08-01
5300,MSD Decatur Township,7313,6330,218,775,-557,208,-765,983,13,3,3,-10,2023-08-01
5310,Franklin Township Com Sch Corp,12639,10829,75,812,-737,998,-1735,1810,14,1,8,-14,2023-08-01
5330,MSD Lawrence Township,16642,14124,1755,1509,246,1009,-763,2518,15,11,6,-5,2023-08-01
5340,Perry Township Schools,18758,15679,324,1064,-740,2015,-2755,3079,16,2,11,-15,2023-08-01
5350,MSD Pike Township,12261,10320,0,1065,-1065,876,-1941,1941,16,0,7,-16,2023-08-01
5360,MSD Warren Township,13128,10352,1093,1902,-809,874,-1683,2776,21,8,7,-13,2023-08-01
5370,MSD Washington Township,11265,9565,794,880,-86,820,-906,1700,15,7,7,-8,2023-08-01
5375,MSD Wayne Township,16189,14737,1294,864,430,588,-158,1452,9,8,4,-1,2023-08-01
5380,Beech Grove City Schools,2054,1688,1098,206,892,160,732,366,18,53,8,36,2023-08-01
5385,Indianapolis Public Schools,47944,20301,959,23459,-22500,4184,-26684,27643,58,2,9,-56,2023-08-01
5400,School Town of Speedway,2120,1854,0,218,-218,48,-266,266,13,0,2,-13,2023-08-01
5455,Culver Community Schools Corp,869,643,145,204,-59,22,-81,226,26,17,3,-9,2023-08-01
5470,Argos Community Schools,656,506,152,148,4,2,2,150,23,23,0,0,2023-08-01
5480,Bremen Public Schools,1252,1166,285,83,202,3,199,86,7,23,0,16,2023-08-01
5485,Plymouth Community School Corp,3342,2858,320,364,-44,120,-164,484,14,10,4,-5,2023-08-01
5495,Triton School Corporation,874,760,178,108,70,6,64,114,13,20,1,7,2023-08-01
5520,Shoals Community School Corp,657,592,43,65,-22,0,-22,65,10,7,0,-3,2023-08-01
5525,Loogootee Community Sch Corp,815,634,105,177,-72,4,-76,181,22,13,0,-9,2023-08-01
5615,Maconaquah School Corp,1972,1540,331,420,-89,12,-101,432,22,17,1,-5,2023-08-01
5620,North Miami Community Schools,780,637,129,143,-14,0,-14,143,18,17,0,-2,2023-08-01
5625,Oak Hill United School Corp,1201,1086,524,98,426,17,409,115,10,44,1,34,2023-08-01
5635,Peru Community Schools,2015,1580,287,432,-145,3,-148,435,22,14,0,-7,2023-08-01
5705,Richland-Bean Blossom C S C,2776,2376,275,341,-66,59,-125,400,14,10,2,-5,2023-08-01
5740,Monroe County Community Sch Corp,11188,9929,324,910,-586,349,-935,1259,11,3,3,-8,2023-08-01
5835,North Montgomery Com Sch Corp,1859,1585,175,262,-87,12,-99,274,15,9,1,-5,2023-08-01
5845,South Montgomery Com Sch Corp,1719,1474,117,242,-125,3,-128,245,14,7,0,-7,2023-08-01
5855,Crawfordsville Community Schools,2359,2128,258,227,31,4,27,231,10,11,0,1,2023-08-01
5900,Monroe-Gregg School District,1443,1245,286,147,139,51,88,198,14,20,4,6,2023-08-01
5910,Eminence Community School Corp,352,245,53,98,-45,9,-54,107,30,15,3,-15,2023-08-01
5925,MSD Martinsville Schools,4614,3714,179,566,-387,334,-721,900,20,4,7,-16,2023-08-01
5930,Mooresville Con School Corp,4188,3549,758,408,350,231,119,639,15,18,6,3,2023-08-01
5945,North Newton School Corp,1287,1100,33,162,-129,25,-154,187,15,3,2,-12,2023-08-01
5995,South Newton School Corp,829,770,56,59,-3,0,-3,59,7,7,0,-0,2023-08-01
6055,Central Noble Com School Corp,1148,991,156,142,14,15,-1,157,14,14,1,-0,2023-08-01
6060,East Noble School Corporation,3595,3093,227,312,-85,190,-275,502,14,6,5,-8,2023-08-01
6065,West Noble School Corporation,2247,2041,120,196,-76,10,-86,206,9,5,0,-4,2023-08-01
6080,Rising Sun-Ohio Co Com,771,688,85,73,12,10,2,83,11,11,1,0,2023-08-01
6145,Orleans Community Schools,779,675,219,103,116,1,115,104,13,28,0,15,2023-08-01
6155,Paoli Community School Corp,1269,1084,120,179,-59,6,-65,185,15,9,0,-5,2023-08-01
6160,Springs Valley Com School Corp,814,743,94,71,23,0,23,71,9,12,0,3,2023-08-01
6195,Spencer-Owen Community Schools,2510,2035,100,435,-335,40,-375,475,19,4,2,-15,2023-08-01
6260,Southwest Parke Com Sch Corp,851,760,202,90,112,1,111,91,11,24,0,13,2023-08-01
6325,Perry Central Com Schools Corp,969,848,374,119,255,2,253,121,12,39,0,26,2023-08-01
6340,Cannelton City Schools,280,122,85,158,-73,0,-73,158,56,30,0,-26,2023-08-01
6350,Tell City-Troy Twp School Corp,1600,1200,174,399,-225,1,-226,400,25,11,0,-14,2023-08-01
6375,North Central Parke Comm Schl Corp,1211,1071,93,139,-46,1,-47,140,12,8,0,-4,2023-08-01
6445,Pike County School Corp,1762,1453,47,299,-252,10,-262,309,18,3,1,-15,2023-08-01
6460,MSD Boone Township,945,865,135,57,78,23,55,80,8,14,2,6,2023-08-01
6470,Duneland School Corporation,6046,5527,212,397,-185,122,-307,519,9,4,2,-5,2023-08-01
6510,East Porter County School Corp,2364,2166,250,141,109,57,52,198,8,11,2,2,2023-08-01
6520,Porter Township School Corp,1372,1256,127,73,54,43,11,116,8,9,3,1,2023-08-01
6530,Union Township School Corp,1401,1309,119,55,64,37,27,92,7,8,3,2,2023-08-01
6550,Portage Township Schools,7454,6732,54,478,-424,244,-668,722,10,1,3,-9,2023-08-01
6560,Valparaiso Community Schools,6881,6300,100,382,-282,199,-481,581,8,1,3,-7,2023-08-01
6590,MSD Mount Vernon,2368,1999,64,145,-81,224,-305,369,16,3,9,-13,2023-08-01
6600,MSD North Posey Co Schools,1485,1253,136,100,36,132,-96,232,16,9,9,-6,2023-08-01
6620,Eastern Pulaski Community Sch Corp,1016,942,184,72,112,2,110,74,7,18,0,11,2023-08-01
6630,West Central School Corp,652,588,57,55,2,9,-7,64,10,9,1,-1,2023-08-01
6705,South Putnam Community Schools,1035,866,218,167,51,2,49,169,16,21,0,5,2023-08-01
6715,North Putnam Community Schools,1516,1266,47,240,-193,10,-203,250,16,3,1,-13,2023-08-01
6750,Cloverdale Community Schools,1020,893,764,123,641,4,637,127,12,75,0,62,2023-08-01
6755,Greencastle Community School Corp,1816,1599,131,214,-83,3,-86,217,12,7,0,-5,2023-08-01
6795,Union School Corporation,377,148,6939,222,6717,7,6710,229,61,1841,2,1780,2023-08-01
6805,Randolph Southern School Corp,431,340,132,89,43,2,41,91,21,31,0,10,2023-08-01
6820,Monroe Central School Corp,837,728,336,107,229,2,227,109,13,40,0,27,2023-08-01
6825,Randolph Central School Corp,1417,1197,143,217,-74,3,-77,220,16,10,0,-5,2023-08-01
6835,Randolph Eastern School Corp,920,829,33,91,-58,0,-58,91,10,4,0,-6,2023-08-01
6865,South Ripley Com Sch Corp,1159,970,85,160,-75,29,-104,189,16,7,3,-9,2023-08-01
6895,Batesville Community School Corp,2107,1858,328,96,232,153,79,249,12,16,7,4,2023-08-01
6900,Jac-Cen-Del Community Sch Corp,765,628,126,128,-2,9,-11,137,18,16,1,-1,2023-08-01
6910,Milan Community Schools,931,725,289,159,130,47,83,206,22,31,5,9,2023-08-01
6995,Rush County Schools,2111,1774,119,275,-156,62,-218,337,16,6,3,-10,2023-08-01
7150,John Glenn School Corporation,1605,1426,528,133,395,46,349,179,11,33,3,22,2023-08-01
7175,Penn-Harris-Madison School Corp,10753,9324,1765,811,954,618,336,1429,13,16,6,3,2023-08-01
7200,School City of Mishawaka,4876,3799,1254,774,480,303,177,1077,22,26,6,4,2023-08-01
7205,South Bend Community School Corp,22712,14354,327,4805,-4478,3553,-8031,8358,37,1,16,-35,2023-08-01
7215,Union-North United School Corp,1102,785,457,279,178,38,140,317,29,41,3,13,2023-08-01
7230,Scott County School District 1,1425,1267,0,136,-136,22,-158,158,11,0,2,-11,2023-08-01
7255,Scott County School District 2,2591,2321,196,184,12,86,-74,270,10,8,3,-3,2023-08-01
7285,Shelby Eastern Schools,1319,999,181,299,-118,21,-139,320,24,14,2,-11,2023-08-01
7350,Northwestern Con School Corp,1139,1014,322,102,220,23,197,125,11,28,2,17,2023-08-01
7360,Southwestern Con Sch Shelby Co,599,466,118,129,-11,4,-15,133,22,20,1,-3,2023-08-01
7365,Shelbyville Central Schools,3863,3475,245,327,-82,61,-143,388,10,6,2,-4,2023-08-01
7385,North Spencer County Sch Corp,2022,1891,95,115,-20,16,-36,131,6,5,1,-2,2023-08-01
7445,South Spencer County Sch Corp,1159,1029,17,59,-42,71,-113,130,11,1,6,-10,2023-08-01
7495,Oregon-Davis School Corp,628,360,137,264,-127,4,-131,268,43,22,1,-21,2023-08-01
7515,North Judson-San Pierre Sch Corp,1190,884,55,229,-174,77,-251,306,26,5,6,-21,2023-08-01
7525,Knox Community School Corp,1685,1406,255,253,2,26,-24,279,17,15,2,-1,2023-08-01
7605,Fremont Community Schools,914,809,174,101,73,4,69,105,11,19,0,8,2023-08-01
7610,Hamilton Community Schools,485,278,69,204,-135,3,-138,207,43,14,1,-28,2023-08-01
7615,MSD Steuben County,2584,2240,267,336,-69,8,-77,344,13,10,0,-3,2023-08-01
7645,Northeast School Corp,1147,633,111,513,-402,1,-403,514,45,10,0,-35,2023-08-01
7715,Southwest School Corporation,1797,1514,189,283,-94,0,-94,283,16,11,0,-5,2023-08-01
7775,Switzerland County School Corp,1542,1409,48,126,-78,7,-85,133,9,3,0,-6,2023-08-01
7855,Lafayette School Corporation,8036,7094,88,366,-278,576,-854,942,12,1,7,-11,2023-08-01
7865,Tippecanoe School Corp,14965,13620,323,626,-303,719,-1022,1345,9,2,5,-7,2023-08-01
7875,West Lafayette Com School Corp,2267,2168,108,68,40,31,9,99,4,5,1,0,2023-08-01
7935,Tri-Central Community Schools,643,515,254,125,129,3,126,128,20,40,0,20,2023-08-01
7945,Tipton Community School Corp,1562,1288,138,264,-126,10,-136,274,18,9,1,-9,2023-08-01
7950,Union Co/Clg Corner Joint Sch Dist,1222,1155,114,55,59,12,47,67,5,9,1,4,2023-08-01
7995,Evansville Vanderburgh School Corp,24666,20915,338,1185,-847,2566,-3413,3751,15,1,10,-14,2023-08-01
8010,North Vermillion Com Sch Corp,631,577,91,50,41,4,37,54,9,14,1,6,2023-08-01
8020,South Vermillion Com Sch Corp,1739,1525,64,194,-130,20,-150,214,12,4,1,-9,2023-08-01
8030,Vigo County School Corp,14250,13282,118,786,-668,182,-850,968,7,1,1,-6,2023-08-01
8045,Manchester Community Schools,1358,1195,184,138,46,25,21,163,12,14,2,2,2023-08-01
8050,MSD Wabash County Schools,1804,1343,796,447,349,14,335,461,26,44,1,19,2023-08-01
8060,Wabash City Schools,1422,1039,379,366,13,17,-4,383,27,27,1,-0,2023-08-01
8115,MSD Warren County,1476,1394,0,78,-78,4,-82,82,6,0,0,-6,2023-08-01
8130,Warrick County School Corp,10817,9772,240,560,-320,485,-805,1045,10,2,4,-7,2023-08-01
8205,Salem Community Schools,1960,1575,143,379,-236,6,-242,385,20,7,0,-12,2023-08-01
8215,East Washington School Corp,1393,1141,135,239,-104,13,-117,252,18,10,1,-8,2023-08-01
8220,West Washington School Corp,768,628,296,135,161,5,156,140,18,39,1,20,2023-08-01
8305,Nettle Creek School Corporation,954,814,292,140,152,0,152,140,15,31,0,16,2023-08-01
8355,Western Wayne Schools,794,586,100,194,-94,14,-108,208,26,13,2,-14,2023-08-01
8360,Centerville-Abington Com Schs,1354,1230,501,102,399,22,377,124,9,37,2,28,2023-08-01
8375,Northeastern Wayne Schools,925,821,468,86,382,18,364,104,11,51,2,39,2023-08-01
8385,Richmond Community Schools,5545,4226,65,1027,-962,292,-1254,1319,24,1,5,-23,2023-08-01
8425,Southern Wells Com Schools,696,588,293,108,185,0,185,108,16,42,0,27,2023-08-01
8435,Northern Wells Community Schools,2339,1991,434,322,112,26,86,348,15,19,1,4,2023-08-01
8445,MSD Bluffton-Harrison,1546,1367,337,177,160,2,158,179,12,22,0,10,2023-08-01
8515,North White School Corp,1022,873,14,147,-133,2,-135,149,15,1,0,-13,2023-08-01
8525,Frontier School Corporation,701,584,65,108,-43,9,-52,117,17,9,1,-7,2023-08-01
8535,Tri-County School Corporation,743,676,60,65,-5,2,-7,67,9,8,0,-1,2023-08-01
8565,Twin Lakes School Corp,2212,2083,144,110,34,19,15,129,6,7,1,1,2023-08-01
8625,Smith-Green Community Schools,1055,928,202,98,104,29,75,127,12,19,3,7,2023-08-01
8665,Whitley County Con Schools,3580,3272,308,234,74,74,0,308,9,9,2,0,2023-08-01
0015,Adams Central Community Schools,1018,937,308,68,240,13,227,81,8,30,1,22,2022-08-01
0025,North Adams Community Schools,1976,1455,102,335,-233,186,-419,521,26,5,9,-21,2022-08-01
0035,South Adams Schools,1236,1152,76,82,-6,2,-8,84,7,6,0,-1,2022-08-01
0125,MSD Southwest Allen County Schls,8207,7639,108,189,-81,379,-460,568,7,1,5,-6,2022-08-01
0225,Northwest Allen County Schools,8541,7842,73,311,-238,388,-626,699,8,1,5,-7,2022-08-01
0235,Fort Wayne Community Schools,34888,27543,7,2583,-2576,4762,-7338,7345,21,0,14,-21,2022-08-01
0255,East Allen County Schools,10707,8971,923,456,467,1280,-813,1736,16,9,12,-8,2022-08-01
0365,Bartholomew Con School Corp,11941,10937,335,413,-78,591,-669,1004,8,3,5,-6,2022-08-01
0370,Flat Rock-Hawcreek School Corp,884,780,189,90,99,14,85,104,12,21,2,10,2022-08-01
0395,Benton Community School Corp,1751,1541,59,130,-71,80,-151,210,12,3,5,-9,2022-08-01
0515,Blackford County Schools,1730,1465,33,263,-230,2,-232,265,15,2,0,-13,2022-08-01
0615,Western Boone Co Com Sch Dist,1460,1356,248,95,153,9,144,104,7,17,1,10,2022-08-01
0630,Zionsville Community Schools,7636,7466,66,109,-43,61,-104,170,2,1,1,-1,2022-08-01
0665,Lebanon Community School Corp,3599,3180,77,348,-271,71,-342,419,12,2,2,-10,2022-08-01
0670,Brown County School Corporation,1801,1518,51,264,-213,19,-232,283,16,3,1,-13,2022-08-01
0750,Carroll Consolidated School Corp,1101,960,85,129,-44,12,-56,141,13,8,1,-5,2022-08-01
0755,Delphi Community School Corp,1392,1270,107,108,-1,14,-15,122,9,8,1,-1,2022-08-01
0775,Pioneer Regional School Corp,983,896,29,87,-58,0,-58,87,9,3,0,-6,2022-08-01
0815,Lewis Cass Schools,1332,1110,242,220,22,2,20,222,17,18,0,2,2022-08-01
0875,Logansport Community Sch Corp,4287,4028,170,254,-84,5,-89,259,6,4,0,-2,2022-08-01
0935,Borden-Henryville School Corp,2041,1452,231,489,-258,100,-358,589,29,11,5,-18,2022-08-01
0945,Silver Creek School Corporation,2956,2310,587,548,39,98,-59,646,22,20,3,-2,2022-08-01
1000,Clarksville Community School Corp,1369,939,2450,372,2078,58,2020,430,31,179,4,148,2022-08-01
1010,Greater Clark County Schools,11610,9584,419,1637,-1218,389,-1607,2026,17,4,3,-14,2022-08-01
1125,Clay Community Schools,3911,3669,225,238,-13,4,-17,242,6,6,0,-0,2022-08-01
1150,Clinton Central School Corporation,824,683,145,129,16,12,4,141,17,18,1,0,2022-08-01
1160,Clinton Prairie School Corporation,1044,901,267,116,151,27,124,143,14,26,3,12,2022-08-01
1170,Community Schools of Frankfort,3379,2878,88,482,-394,19,-413,501,15,3,1,-12,2022-08-01
1180,Rossville Con School District,816,764,168,31,137,21,116,52,6,21,3,14,2022-08-01
1300,Crawford County Community Sch Corp,1522,1273,42,245,-203,4,-207,249,16,3,0,-14,2022-08-01
1315,Barr-Reeve Community Schools Inc,726,659,333,64,269,3,266,67,9,46,0,37,2022-08-01
1375,North Daviess Com Schools,997,895,184,92,92,10,82,102,10,18,1,8,2022-08-01
1405,Washington Community Schools,2963,2386,17,380,-363,197,-560,577,19,1,7,-19,2022-08-01
1560,Sunman-Dearborn Com Sch Corp,3955,3477,256,367,-111,111,-222,478,12,6,3,-6,2022-08-01
1600,South Dearborn Community Sch Corp,2420,1834,120,486,-366,100,-466,586,24,5,4,-19,2022-08-01
1620,Lawrenceburg Community School Corp,1804,1658,431,125,306,21,285,146,8,24,1,16,2022-08-01
1655,Decatur County Community Schools,1725,1485,288,224,64,16,48,240,14,17,1,3,2022-08-01
1730,Greensburg Community Schools,2277,2041,0,220,-220,16,-236,236,10,0,1,-10,2022-08-01
1805,DeKalb Co Eastern Com Sch Dist,1227,1096,146,117,29,14,15,131,11,12,1,1,2022-08-01
1820,Garrett-Keyser-Butler Com Sch Corp,1626,1460,255,121,134,45,89,166,10,16,3,5,2022-08-01
1835,DeKalb Co Ctl United Sch Dist,3744,3189,228,374,-146,181,-327,555,15,6,5,-9,2022-08-01
1875,Delaware Community School Corp,2595,2193,372,382,-10,20,-30,402,15,14,1,-1,2022-08-01
1885,Wes-Del Community Schools,743,604,269,122,147,17,130,139,19,36,2,17,2022-08-01
1895,Liberty-Perry Community Sch Corp,958,787,393,165,228,6,222,171,18,41,1,23,2022-08-01
1900,Cowan Community School Corp,556,429,367,123,244,4,240,127,23,66,1,43,2022-08-01
1910,Yorktown Community Schools,2353,2085,609,231,378,37,341,268,11,26,2,14,2022-08-01
1940,Daleville Community Schools,621,487,488,128,360,6,354,134,22,79,1,57,2022-08-01
1970,Muncie Community Schools,7219,4736,164,2317,-2153,166,-2319,2483,34,2,2,-32,2022-08-01
2040,Northeast Dubois Co Sch Corp,783,715,89,64,25,4,21,68,9,11,1,3,2022-08-01
2100,Southeast Dubois Co Sch Corp,1193,1110,114,76,38,7,31,83,7,10,1,3,2022-08-01
2110,Southwest Dubois Co Sch Corp,1770,1670,140,94,46,6,40,100,6,8,0,2,2022-08-01
2120,Greater Jasper Consolidated Schs,3262,2994,159,145,14,123,-109,268,8,5,4,-3,2022-08-01
2155,Fairfield Community Schools,2025,1829,322,173,149,23,126,196,10,16,1,6,2022-08-01
2260,Baugo Community Schools,1781,1554,297,174,123,53,70,227,13,17,3,4,2022-08-01
2270,Concord Community Schools,4963,4410,827,419,408,134,274,553,11,17,3,6,2022-08-01
2275,Middlebury Community Schools,4079,3712,506,294,212,73,139,367,9,12,2,3,2022-08-01
2285,Wa-Nee Community Schools,2787,2616,256,129,127,42,85,171,6,9,2,3,2022-08-01
2305,Elkhart Community Schools,13338,11007,296,1856,-1560,475,-2035,2331,17,2,4,-15,2022-08-01
2315,Goshen Community Schools,6732,5831,425,599,-174,302,-476,901,13,6,4,-7,2022-08-01
2395,Fayette County School Corporation,3311,2956,42,279,-237,76,-313,355,11,1,2,-9,2022-08-01
2400,New Albany-Floyd Co Con Sch,11754,10390,953,948,5,416,-411,1364,12,8,4,-3,2022-08-01
2435,Attica Consolidated School Corp,560,501,43,53,-10,6,-16,59,11,8,1,-3,2022-08-01
2440,Covington Community School Corp,815,729,72,49,23,37,-14,86,11,9,5,-2,2022-08-01
2455,Southeast Fountain School Corp,1023,917,45,102,-57,4,-61,106,10,4,0,-6,2022-08-01
2475,Franklin County Community Sch Corp,2287,1961,44,254,-210,72,-282,326,14,2,3,-12,2022-08-01
2645,Rochester Community School Corp,1727,1446,143,281,-138,0,-138,281,16,8,0,-8,2022-08-01
2650,Caston School Corporation,757,612,157,145,12,0,12,145,19,21,0,2,2022-08-01
2725,East Gibson School Corporation,896,715,28,171,-143,10,-153,181,20,3,1,-17,2022-08-01
2735,North Gibson School Corporation,2061,1767,81,240,-159,54,-213,294,14,4,3,-10,2022-08-01
2765,South Gibson School Corporation,2000,1766,289,126,163,108,55,234,12,14,5,3,2022-08-01
2815,Eastbrook Community Sch Corp,1318,1166,381,133,248,19,229,152,12,29,1,17,2022-08-01
2825,Madison-Grant United School Corp,1208,982,492,196,296,30,266,226,19,41,2,22,2022-08-01
2855,Mississinewa Community School Corp,1707,1591,714,104,610,12,598,116,7,42,1,35,2022-08-01
2865,Marion Community Schools,5070,3447,49,1377,-1328,246,-1574,1623,32,1,5,-31,2022-08-01
2920,Bloomfield School District,918,773,40,145,-105,0,-105,145,16,4,0,-11,2022-08-01
2940,Eastern Greene Schools,1046,918,131,106,25,22,3,128,12,13,2,0,2022-08-01
2950,Linton-Stockton School Corporation,1241,1052,235,186,49,3,46,189,15,19,0,4,2022-08-01
2960,MSD Shakamak Schools,764,586,52,178,-126,0,-126,178,23,7,0,-16,2022-08-01
2980,White River Valley School District,823,632,124,190,-66,1,-67,191,23,15,0,-8,2022-08-01
3005,Hamilton Southeastern Schools,22621,21308,69,697,-628,616,-1244,1313,6,0,3,-5,2022-08-01
3025,Hamilton Heights School Corp,1995,1866,329,101,228,28,200,129,6,16,1,10,2022-08-01
3030,Westfield-Washington Schools,9097,8688,66,313,-247,96,-343,409,4,1,1,-4,2022-08-01
3055,Sheridan Community Schools,1003,904,142,88,54,11,43,99,10,14,1,4,2022-08-01
3060,Carmel Clay Schools,16388,15935,214,310,-96,143,-239,453,3,1,1,-1,2022-08-01
3070,Noblesville Schools,11228,10300,85,624,-539,304,-843,928,8,1,3,-8,2022-08-01
3115,Southern Hancock Co Com Sch Corp,3230,3007,600,162,438,61,377,223,7,19,2,12,2022-08-01
3125,Greenfield-Central Com Schools,4601,3971,246,543,-297,87,-384,630,14,5,2,-8,2022-08-01
3135,Mt Vernon Community School Corp,4250,3730,641,389,252,131,121,520,12,15,3,3,2022-08-01
3145,Eastern Hancock Co Com Sch Corp,893,777,361,110,251,6,245,116,13,40,1,27,2022-08-01
3160,Lanesville Community School Corp,623,508,238,100,138,15,123,115,18,38,2,20,2022-08-01
3180,North Harrison Com School Corp,2145,1802,298,315,-17,28,-45,343,16,14,1,-2,2022-08-01
3190,South Harrison Com Schools,3228,2796,169,339,-170,93,-263,432,13,5,3,-8,2022-08-01
3295,North West Hendricks Schools,1832,1669,217,100,117,63,54,163,9,12,3,3,2022-08-01
3305,Brownsburg Community School Corp,10162,9515,137,338,-201,309,-510,647,6,1,3,-5,2022-08-01
3315,Avon Community School Corp,10878,9940,136,594,-458,344,-802,938,9,1,3,-7,2022-08-01
3325,Danville Community School Corp,2539,2315,216,185,31,39,-8,224,9,9,2,-0,2022-08-01
3330,Plainfield Community School Corp,5451,5081,471,279,192,91,101,370,7,9,2,2,2022-08-01
3335,Mill Creek Community Sch Corp,1534,1337,151,179,-28,18,-46,197,13,10,1,-3,2022-08-01
3405,Blue River Valley Schools,588,429,168,151,17,8,9,159,27,29,1,2,2022-08-01
3415,South Henry School Corp,631,491,214,134,80,6,74,140,22,34,1,12,2022-08-01
3435,Shenandoah School Corporation,1189,1048,259,123,136,18,118,141,12,22,2,10,2022-08-01
3445,New Castle Community School Corp,3122,2648,184,468,-284,6,-290,474,15,6,0,-9,2022-08-01
3455,C A Beard Memorial School Corp,1294,946,85,347,-262,1,-263,348,27,7,0,-20,2022-08-01
3460,Taylor Community School Corp,1321,790,473,513,-40,18,-58,531,40,36,1,-4,2022-08-01
3470,Northwestern School Corp,1521,1281,568,226,342,14,328,240,16,37,1,22,2022-08-01
3480,Eastern Howard School Corporation,1011,922,631,82,549,7,542,89,9,62,1,54,2022-08-01
3490,Western School Corporation,2279,1963,552,299,253,17,236,316,14,24,1,10,2022-08-01
3500,Kokomo School Corporation,6439,4529,306,1766,-1460,144,-1604,1910,30,5,2,-25,2022-08-01
3625,Huntington Co Com Sch Corp,5349,4738,86,461,-375,150,-525,611,11,2,3,-10,2022-08-01
3640,Medora Community School Corp,201,124,25,76,-51,1,-52,77,38,12,0,-26,2022-08-01
3675,Seymour Community Schools,5560,5006,172,204,-32,350,-382,554,10,3,6,-7,2022-08-01
3695,Brownstown Cnt Com Sch Corp,1411,1250,152,116,36,45,-9,161,11,11,3,-1,2022-08-01
3710,Crothersville Community Schools,570,457,0,100,-100,13,-113,113,20,0,2,-20,2022-08-01
3785,Kankakee Valley School Corp,3454,3074,113,169,-56,211,-267,380,11,3,6,-8,2022-08-01
3815,Rensselaer Central School Corp,1511,1364,77,109,-32,38,-70,147,10,5,3,-5,2022-08-01
3945,Jay School Corporation,3183,2847,98,199,-101,137,-238,336,11,3,4,-7,2022-08-01
3995,Madison Consolidated Schools,3227,2442,104,510,-406,275,-681,785,24,3,9,-21,2022-08-01
4000,Southwestern-Jefferson Co Con,1185,942,254,187,67,56,11,243,21,21,5,1,2022-08-01
4015,Jennings County School Corporation,4270,3825,128,300,-172,145,-317,445,10,3,3,-7,2022-08-01
4145,Clark-Pleasant Community Sch Corp,7453,6489,191,716,-525,248,-773,964,13,3,3,-10,2022-08-01
4205,Center Grove Community School Corp,9451,8599,506,549,-43,303,-346,852,9,5,3,-4,2022-08-01
4215,Edinburgh Community School Corp,800,666,151,118,33,16,17,134,17,19,2,2,2022-08-01
4225,Franklin Community School Corp,5086,4439,309,515,-206,132,-338,647,13,6,3,-7,2022-08-01
4245,Greenwood Community Sch Corp,3600,3178,715,286,429,136,293,422,12,20,4,8,2022-08-01
4255,Nineveh-Hensley-Jackson United,1796,1597,404,170,234,29,205,199,11,22,2,11,2022-08-01
4315,North Knox School Corp,1389,1188,12,177,-165,24,-189,201,14,1,2,-14,2022-08-01
4325,South Knox School Corp,1057,952,272,78,194,27,167,105,10,26,3,16,2022-08-01
4335,Vincennes Community School Corp,3045,2644,128,288,-160,113,-273,401,13,4,4,-9,2022-08-01
4345,Wawasee Community School Corp,2885,2587,185,277,-92,21,-113,298,10,6,1,-4,2022-08-01
4415,Warsaw Community Schools,6844,6205,438,445,-7,194,-201,639,9,6,3,-3,2022-08-01
4445,Tippecanoe Valley School Corp,1858,1563,182,283,-101,12,-113,295,16,10,1,-6,2022-08-01
4455,Whitko Community School Corp,1505,1096,108,377,-269,32,-301,409,27,7,2,-20,2022-08-01
4515,Prairie Heights Community Sch Corp,1273,1092,258,179,79,2,77,181,14,20,0,6,2022-08-01
4525,Westview School Corporation,1906,1789,282,101,181,16,165,117,6,15,1,9,2022-08-01
4535,Lakeland School Corporation,1967,1594,60,369,-309,4,-313,373,19,3,0,-16,2022-08-01
4580,Hanover Community School Corp,2763,2569,22,74,-52,120,-172,194,7,1,4,-6,2022-08-01
4590,River Forest Community Sch Corp,1389,1262,328,87,241,40,201,127,9,24,3,14,2022-08-01
4600,Merrillville Community School Corp,6592,5811,50,425,-375,356,-731,781,12,1,5,-11,2022-08-01
4615,Lake Central School Corporation,9568,9073,74,253,-179,242,-421,495,5,1,3,-4,2022-08-01
4645,Tri-Creek School Corporation,3327,3155,71,103,-32,69,-101,172,5,2,2,-3,2022-08-01
4650,Lake Ridge New Tech Schools,1737,1510,43,143,-100,84,-184,227,13,2,5,-11,2022-08-01
4660,Crown Point Community School Corp,9187,8714,4,222,-218,251,-469,473,5,0,3,-5,2022-08-01
4670,School City of East Chicago,4752,3122,84,1250,-1166,380,-1546,1630,34,2,8,-33,2022-08-01
4680,Lake Station Community Schools,1350,1048,116,231,-115,71,-186,302,22,9,5,-14,2022-08-01
4690,Gary Community School Corp,11073,4127,0,6411,-6411,535,-6946,6946,63,0,5,-63,2022-08-01
4700,Griffith Public Schools,2183,1919,71,170,-99,94,-193,264,12,3,4,-9,2022-08-01
4710,School City of Hammond,13074,10641,498,1444,-946,989,-1935,2433,19,4,8,-15,2022-08-01
4720,School Town of Highland,3188,2954,65,113,-48,121,-169,234,7,2,4,-5,2022-08-01
4730,School City of Hobart,4219,3996,24,157,-133,66,-199,223,5,1,2,-5,2022-08-01
4740,School Town of Munster,4035,3908,190,69,121,58,63,127,3,5,1,2,2022-08-01
4760,School City of Whiting,806,735,393,49,344,22,322,71,9,49,3,40,2022-08-01
4805,New Prairie United School Corp,2470,2317,615,132,483,21,462,153,6,25,1,19,2022-08-01
4860,MSD of New Durham Township,749,608,276,128,148,13,135,141,19,37,2,18,2022-08-01
4915,Tri-Township Cons School Corp,480,234,73,246,-173,0,-173,246,51,15,0,-36,2022-08-01
4925,Michigan City Area Schools,6038,4860,330,802,-472,376,-848,1178,20,5,6,-14,2022-08-01
4940,South Central Com School Corp,674,600,349,62,287,12,275,74,11,52,2,41,2022-08-01
4945,LaPorte Community School Corp,6534,5529,236,876,-640,129,-769,1005,15,4,2,-12,2022-08-01
5075,North Lawrence Com Schools,4587,3734,89,723,-634,130,-764,853,19,2,3,-17,2022-08-01
5085,Mitchell Community Schools,1608,1370,66,230,-164,8,-172,238,15,4,0,-11,2022-08-01
5245,Frankton-Lapel Community Schools,2144,2027,928,96,832,21,811,117,5,43,1,38,2022-08-01
5255,South Madison Com Sch Corp,4045,3810,586,199,387,36,351,235,6,14,1,9,2022-08-01
5265,Alexandria Community School Corp,1488,1241,229,185,44,62,-18,247,17,15,4,-1,2022-08-01
5275,Anderson Community School Corp,9898,6242,27,2934,-2907,722,-3629,3656,37,0,7,-37,2022-08-01
5280,Elwood Community School Corp,1510,1276,100,223,-123,11,-134,234,15,7,1,-9,2022-08-01
5300,MSD Decatur Township,7200,6242,255,763,-508,195,-703,958,13,4,3,-10,2022-08-01
5310,Franklin Township Com Sch Corp,12270,10703,81,866,-785,701,-1486,1567,13,1,6,-12,2022-08-01
5330,MSD Lawrence Township,16460,14158,1636,1451,185,851,-666,2302,14,10,5,-4,2022-08-01
5340,Perry Township Schools,18473,15817,345,1011,-666,1645,-2311,2656,14,2,9,-13,2022-08-01
5350,MSD Pike Township,12533,10698,0,1069,-1069,766,-1835,1835,15,0,6,-15,2022-08-01
5360,MSD Warren Township,13200,10547,898,1881,-983,772,-1755,2653,20,7,6,-13,2022-08-01
5370,MSD Washington Township,11297,9756,824,875,-51,666,-717,1541,14,7,6,-6,2022-08-01
5375,MSD Wayne Township,15898,14589,1492,791,701,518,183,1309,8,9,3,1,2022-08-01
5380,Beech Grove City Schools,1982,1682,1082,181,901,119,782,300,15,55,6,39,2022-08-01
5385,Indianapolis Public Schools,47360,20238,1026,23092,-22066,4030,-26096,27122,57,2,9,-55,2022-08-01
5400,School Town of Speedway,2091,1831,0,218,-218,42,-260,260,12,0,2,-12,2022-08-01
5455,Culver Community Schools Corp,862,647,127,197,-70,18,-88,215,25,15,2,-10,2022-08-01
5470,Argos Community Schools,647,497,135,145,-10,5,-15,150,23,21,1,-2,2022-08-01
5480,Bremen Public Schools,1243,1184,267,57,210,2,208,59,5,21,0,17,2022-08-01
5485,Plymouth Community School Corp,3321,2882,381,348,33,91,-58,439,13,11,3,-2,2022-08-01
5495,Triton School Corporation,848,753,169,94,75,1,74,95,11,20,0,9,2022-08-01
5520,Shoals Community School Corp,653,588,45,63,-18,2,-20,65,10,7,0,-3,2022-08-01
5525,Loogootee Community Sch Corp,805,634,108,171,-63,0,-63,171,21,13,0,-8,2022-08-01
5615,Maconaquah School Corp,2021,1607,282,403,-121,11,-132,414,20,14,1,-7,2022-08-01
5620,North Miami Community Schools,787,658,132,129,3,0,3,129,16,17,0,0,2022-08-01
5625,Oak Hill United School Corp,1209,1099,522,87,435,23,412,110,9,43,2,34,2022-08-01
5635,Peru Community Schools,1984,1605,293,378,-85,1,-86,379,19,15,0,-4,2022-08-01
5705,Richland-Bean Blossom C S C,2792,2396,250,346,-96,50,-146,396,14,9,2,-5,2022-08-01
5740,Monroe County Community Sch Corp,11103,9929,320,887,-567,287,-854,1174,11,3,3,-8,2022-08-01
5835,North Montgomery Com Sch Corp,1890,1644,157,239,-82,7,-89,246,13,8,0,-5,2022-08-01
5845,South Montgomery Com Sch Corp,1707,1456,95,250,-155,1,-156,251,15,6,0,-9,2022-08-01
5855,Crawfordsville Community Schools,2330,2130,246,200,46,0,46,200,9,11,0,2,2022-08-01
5900,Monroe-Gregg School District,1407,1236,286,129,157,42,115,171,12,20,3,8,2022-08-01
5910,Eminence Community School Corp,382,274,53,100,-47,8,-55,108,28,14,2,-14,2022-08-01
5925,MSD Martinsville Schools,4566,3734,159,549,-390,283,-673,832,18,3,6,-15,2022-08-01
5930,Mooresville Con School Corp,4165,3584,689,401,288,180,108,581,14,17,4,3,2022-08-01
5945,North Newton School Corp,1299,1137,34,148,-114,14,-128,162,12,3,1,-10,2022-08-01
5995,South Newton School Corp,799,748,57,49,8,2,6,51,6,7,0,1,2022-08-01
6055,Central Noble Com School Corp,1145,1005,158,132,26,8,18,140,12,14,1,2,2022-08-01
6060,East Noble School Corporation,3552,3100,231,322,-91,130,-221,452,13,7,4,-6,2022-08-01
6065,West Noble School Corporation,2233,2048,133,183,-50,2,-52,185,8,6,0,-2,2022-08-01
6080,Rising Sun-Ohio Co Com,795,724,73,61,12,10,2,71,9,9,1,0,2022-08-01
6145,Orleans Community Schools,753,668,193,85,108,0,108,85,11,26,0,14,2022-08-01
6155,Paoli Community School Corp,1256,1100,128,153,-25,3,-28,156,12,10,0,-2,2022-08-01
6160,Springs Valley Com School Corp,805,715,86,90,-4,0,-4,90,11,11,0,-0,2022-08-01
6195,Spencer-Owen Community Schools,2505,2046,104,424,-320,35,-355,459,18,4,1,-14,2022-08-01
6260,Southwest Parke Com Sch Corp,847,757,218,90,128,0,128,90,11,26,0,15,2022-08-01
6325,Perry Central Com Schools Corp,942,830,373,110,263,2,261,112,12,40,0,28,2022-08-01
6340,Cannelton City Schools,276,123,96,153,-57,0,-57,153,55,35,0,-21,2022-08-01
6350,Tell City-Troy Twp School Corp,1628,1235,144,392,-248,1,-249,393,24,9,0,-15,2022-08-01
6375,North Central Parke Comm Schl Corp,1185,1054,97,130,-33,1,-34,131,11,8,0,-3,2022-08-01
6445,Pike County School Corp,1767,1487,57,275,-218,5,-223,280,16,3,0,-13,2022-08-01
6460,MSD Boone Township,976,889,130,74,56,13,43,87,9,13,1,4,2022-08-01
6470,Duneland School Corporation,6037,5570,236,399,-163,68,-231,467,8,4,1,-4,2022-08-01
6510,East Porter County School Corp,2399,2213,240,138,102,48,54,186,8,10,2,2,2022-08-01
6520,Porter Township School Corp,1365,1275,119,56,63,34,29,90,7,9,2,2,2022-08-01
6530,Union Township School Corp,1407,1332,102,55,47,20,27,75,5,7,1,2,2022-08-01
6550,Portage Township Schools,7529,6846,48,499,-451,184,-635,683,9,1,2,-8,2022-08-01
6560,Valparaiso Community Schools,6780,6258,99,388,-289,134,-423,522,8,1,2,-6,2022-08-01
6590,MSD Mount Vernon,2242,1939,69,142,-73,161,-234,303,14,3,7,-10,2022-08-01
6600,MSD North Posey Co Schools,1501,1278,139,108,31,115,-84,223,15,9,8,-6,2022-08-01
6620,Eastern Pulaski Community Sch Corp,1016,950,190,66,124,0,124,66,6,19,0,12,2022-08-01
6630,West Central School Corp,667,587,43,67,-24,13,-37,80,12,6,2,-6,2022-08-01
6705,South Putnam Community Schools,1031,861,178,170,8,0,8,170,16,17,0,1,2022-08-01
6715,North Putnam Community Schools,1498,1249,49,245,-196,4,-200,249,17,3,0,-13,2022-08-01
6750,Cloverdale Community Schools,1018,899,492,113,379,6,373,119,12,48,1,37,2022-08-01
6755,Greencastle Community School Corp,1793,1601,143,189,-46,3,-49,192,11,8,0,-3,2022-08-01
6795,Union School Corporation,365,169,7074,194,6880,2,6878,196,54,1938,1,1884,2022-08-01
6805,Randolph Southern School Corp,438,357,114,80,34,1,33,81,18,26,0,8,2022-08-01
6820,Monroe Central School Corp,845,743,313,102,211,0,211,102,12,37,0,25,2022-08-01
6825,Randolph Central School Corp,1374,1156,128,213,-85,5,-90,218,16,9,0,-7,2022-08-01
6835,Randolph Eastern School Corp,898,819,31,79,-48,0,-48,79,9,3,0,-5,2022-08-01
6865,South Ripley Com Sch Corp,1175,988,90,165,-75,22,-97,187,16,8,2,-8,2022-08-01
6895,Batesville Community School Corp,2093,1849,293,100,193,144,49,244,12,14,7,2,2022-08-01
6900,Jac-Cen-Del Community Sch Corp,780,652,125,118,7,10,-3,128,16,16,1,-0,2022-08-01
6910,Milan Community Schools,873,703,258,141,117,29,88,170,19,30,3,10,2022-08-01
6995,Rush County Schools,2070,1740,113,270,-157,60,-217,330,16,5,3,-10,2022-08-01
7150,John Glenn School Corporation,1586,1395,561,146,415,45,370,191,12,35,3,23,2022-08-01
7175,Penn-Harris-Madison School Corp,10343,9186,1682,771,911,386,525,1157,11,16,4,5,2022-08-01
7200,School City of Mishawaka,4757,3808,1311,693,618,256,362,949,20,28,5,8,2022-08-01
7205,South Bend Community School Corp,22432,14630,261,4684,-4423,3118,-7541,7802,35,1,14,-34,2022-08-01
7215,Union-North United School Corp,1108,799,445,283,162,26,136,309,28,40,2,12,2022-08-01
7230,Scott County School District 1,1312,1174,0,124,-124,14,-138,138,11,0,1,-11,2022-08-01
7255,Scott County School District 2,2516,2270,206,177,29,69,-40,246,10,8,3,-2,2022-08-01
7285,Shelby Eastern Schools,1306,988,176,306,-130,12,-142,318,24,13,1,-11,2022-08-01
7350,Northwestern Con School Corp,1166,1047,317,102,215,17,198,119,10,27,1,17,2022-08-01
7360,Southwestern Con Sch Shelby Co,589,459,106,127,-21,3,-24,130,22,18,1,-4,2022-08-01
7365,Shelbyville Central Schools,3794,3477,242,258,-16,59,-75,317,8,6,2,-2,2022-08-01
7385,North Spencer County Sch Corp,1993,1857,106,119,-13,17,-30,136,7,5,1,-2,2022-08-01
7445,South Spencer County Sch Corp,1155,1035,27,66,-39,54,-93,120,10,2,5,-8,2022-08-01
7495,Oregon-Davis School Corp,610,333,134,274,-140,3,-143,277,45,22,0,-23,2022-08-01
7515,North Judson-San Pierre Sch Corp,1189,880,57,237,-180,72,-252,309,26,5,6,-21,2022-08-01
7525,Knox Community School Corp,1703,1419,252,259,-7,25,-32,284,17,15,1,-2,2022-08-01
7605,Fremont Community Schools,921,807,184,114,70,0,70,114,12,20,0,8,2022-08-01
7610,Hamilton Community Schools,480,276,75,202,-127,2,-129,204,42,16,0,-27,2022-08-01
7615,MSD Steuben County,2556,2215,273,335,-62,6,-68,341,13,11,0,-3,2022-08-01
7645,Northeast School Corp,1155,646,95,508,-413,1,-414,509,44,8,0,-36,2022-08-01
7715,Southwest School Corporation,1700,1418,181,282,-101,0,-101,282,17,11,0,-6,2022-08-01
7775,Switzerland County School Corp,1543,1420,45,117,-72,6,-78,123,8,3,0,-5,2022-08-01
7855,Lafayette School Corporation,7823,6998,76,339,-263,486,-749,825,11,1,6,-10,2022-08-01
7865,Tippecanoe School Corp,14622,13471,273,593,-320,558,-878,1151,8,2,4,-6,2022-08-01
7875,West Lafayette Com School Corp,2260,2153,88,82,6,25,-19,107,5,4,1,-1,2022-08-01
7935,Tri-Central Community Schools,601,481,246,119,127,1,126,120,20,41,0,21,2022-08-01
7945,Tipton Community School Corp,1582,1324,111,248,-137,10,-147,258,16,7,1,-9,2022-08-01
7950,Union Co/Clg Corner Joint Sch Dist,1196,1142,106,52,54,2,52,54,5,9,0,4,2022-08-01
7995,Evansville Vanderburgh School Corp,23975,20835,339,1176,-837,1964,-2801,3140,13,1,8,-12,2022-08-01
8010,North Vermillion Com Sch Corp,662,610,78,49,29,3,26,52,8,12,0,4,2022-08-01
8020,South Vermillion Com Sch Corp,1703,1495,75,202,-127,6,-133,208,12,4,0,-8,2022-08-01
8030,Vigo County School Corp,14081,13126,118,788,-670,167,-837,955,7,1,1,-6,2022-08-01
8045,Manchester Community Schools,1347,1222,185,119,66,6,60,125,9,14,0,4,2022-08-01
8050,MSD Wabash County Schools,1740,1323,775,398,377,19,358,417,24,45,1,21,2022-08-01
8060,Wabash City Schools,1492,1110,327,369,-42,13,-55,382,26,22,1,-4,2022-08-01
8115,MSD Warren County,1420,1344,0,71,-71,5,-76,76,5,0,0,-5,2022-08-01
8130,Warrick County School Corp,10621,9715,226,551,-325,355,-680,906,9,2,3,-6,2022-08-01
8205,Salem Community Schools,1921,1565,133,352,-219,4,-223,356,19,7,0,-12,2022-08-01
8215,East Washington School Corp,1367,1161,176,197,-21,9,-30,206,15,13,1,-2,2022-08-01
8220,West Washington School Corp,779,647,228,125,103,7,96,132,17,29,1,12,2022-08-01
8305,Nettle Creek School Corporation,953,794,272,157,115,2,113,159,17,29,0,12,2022-08-01
8355,Western Wayne Schools,800,619,118,169,-51,12,-63,181,23,15,2,-8,2022-08-01
8360,Centerville-Abington Com Schs,1409,1274,463,115,348,20,328,135,10,33,1,23,2022-08-01
8375,Northeastern Wayne Schools,921,826,427,82,345,13,332,95,10,46,1,36,2022-08-01
8385,Richmond Community Schools,5492,4264,93,973,-880,255,-1135,1228,22,2,5,-21,2022-08-01
8425,Southern Wells Com Schools,696,589,260,106,154,1,153,107,15,37,0,22,2022-08-01
8435,Northern Wells Community Schools,2304,1959,436,315,121,30,91,345,15,19,1,4,2022-08-01
8445,MSD Bluffton-Harrison,1556,1368,343,186,157,2,155,188,12,22,0,10,2022-08-01
8515,North White School Corp,1004,866,22,138,-116,0,-116,138,14,2,0,-12,2022-08-01
8525,Frontier School Corporation,701,586,69,110,-41,5,-46,115,16,10,1,-7,2022-08-01
8535,Tri-County School Corporation,749,685,60,64,-4,0,-4,64,9,8,0,-1,2022-08-01
8565,Twin Lakes School Corp,2186,2045,135,124,11,17,-6,141,6,6,1,-0,2022-08-01
8625,Smith-Green Community Schools,1083,962,212,99,113,22,91,121,11,20,2,8,2022-08-01
8665,Whitley County Con Schools,3522,3222,306,230,76,70,6,300,9,9,2,0,2022-08-01
0015,Adams Central Community Schools,1049,964,304,77,227,8,219,85,8,29,1,21,2021-08-01
0025,North Adams Community Schools,1935,1465,98,333,-235,137,-372,470,24,5,7,-19,2021-08-01
0035,South Adams Schools,1183,1095,85,85,0,3,-3,88,7,7,0,-0,2021-08-01
0125,MSD Southwest Allen County Schls,7873,7513,110,135,-25,225,-250,360,5,1,3,-3,2021-08-01
0225,Northwest Allen County Schools,8317,7795,63,298,-235,224,-459,522,6,1,3,-6,2021-08-01
0235,Fort Wayne Community Schools,34224,27625,67,2514,-2447,4085,-6532,6599,19,0,12,-19,2021-08-01
0255,East Allen County Schools,10232,8758,873,492,381,982,-601,1474,14,9,10,-6,2021-08-01
0365,Bartholomew Con School Corp,11695,10840,325,394,-69,461,-530,855,7,3,4,-5,2021-08-01
0370,Flat Rock-Hawcreek School Corp,888,794,168,87,81,7,74,94,11,19,1,8,2021-08-01
0395,Benton Community School Corp,1767,1557,66,145,-79,65,-144,210,12,4,4,-8,2021-08-01
0515,Blackford County Schools,1721,1480,32,237,-205,4,-209,241,14,2,0,-12,2021-08-01
0615,Western Boone Co Com Sch Dist,1537,1435,201,92,109,10,99,102,7,13,1,6,2021-08-01
0630,Zionsville Community Schools,7378,7230,45,113,-68,35,-103,148,2,1,0,-1,2021-08-01
0665,Lebanon Community School Corp,3511,3182,84,266,-182,63,-245,329,9,2,2,-7,2021-08-01
0670,Brown County School Corporation,1866,1607,62,237,-175,22,-197,259,14,3,1,-11,2021-08-01
0750,Carroll Consolidated School Corp,1074,929,81,136,-55,9,-64,145,14,8,1,-6,2021-08-01
0755,Delphi Community School Corp,1427,1288,97,125,-28,14,-42,139,10,7,1,-3,2021-08-01
0775,Pioneer Regional School Corp,993,907,31,85,-54,1,-55,86,9,3,0,-6,2021-08-01
0815,Lewis Cass Schools,1297,1055,214,240,-26,2,-28,242,19,16,0,-2,2021-08-01
0875,Logansport Community Sch Corp,4246,4008,194,237,-43,1,-44,238,6,5,0,-1,2021-08-01
0935,Borden-Henryville School Corp,2026,1541,194,443,-249,42,-291,485,24,10,2,-14,2021-08-01
0945,Silver Creek School Corporation,2881,2320,459,480,-21,81,-102,561,19,16,3,-4,2021-08-01
1000,Clarksville Community School Corp,1320,937,2885,330,2555,53,2502,383,29,219,4,190,2021-08-01
1010,Greater Clark County Schools,11623,9842,379,1496,-1117,285,-1402,1781,15,3,2,-12,2021-08-01
1125,Clay Community Schools,3956,3733,214,223,-9,0,-9,223,6,5,0,-0,2021-08-01
1150,Clinton Central School Corporation,798,657,121,132,-11,9,-20,141,18,15,1,-3,2021-08-01
1160,Clinton Prairie School Corporation,1028,922,255,88,167,18,149,106,10,25,2,14,2021-08-01
1170,Community Schools of Frankfort,3366,2891,85,456,-371,19,-390,475,14,3,1,-12,2021-08-01
1180,Rossville Con School District,842,771,151,57,94,14,80,71,8,18,2,10,2021-08-01
1300,Crawford County Community Sch Corp,1486,1284,51,199,-148,3,-151,202,14,3,0,-10,2021-08-01
1315,Barr-Reeve Community Schools Inc,751,677,311,69,242,5,237,74,10,41,1,32,2021-08-01
1375,North Daviess Com Schools,1025,941,177,79,98,5,93,84,8,17,0,9,2021-08-01
1405,Washington Community Schools,2921,2403,19,352,-333,166,-499,518,18,1,6,-17,2021-08-01
1560,Sunman-Dearborn Com Sch Corp,3914,3476,194,343,-149,95,-244,438,11,5,2,-6,2021-08-01
1600,South Dearborn Community Sch Corp,2450,1947,130,433,-303,70,-373,503,21,5,3,-15,2021-08-01
1620,Lawrenceburg Community School Corp,1791,1657,389,125,264,9,255,134,7,22,1,14,2021-08-01
1655,Decatur County Community Schools,1741,1528,313,195,118,18,100,213,12,18,1,6,2021-08-01
1730,Greensburg Community Schools,2315,2055,0,246,-246,14,-260,260,11,0,1,-11,2021-08-01
1805,DeKalb Co Eastern Com Sch Dist,1250,1127,138,106,32,17,15,123,10,11,1,1,2021-08-01
1820,Garrett-Keyser-Butler Com Sch Corp,1612,1444,252,131,121,37,84,168,10,16,2,5,2021-08-01
1835,DeKalb Co Ctl United Sch Dist,3674,3180,202,389,-187,105,-292,494,13,5,3,-8,2021-08-01
1875,Delaware Community School Corp,2496,2174,432,301,131,21,110,322,13,17,1,4,2021-08-01
1885,Wes-Del Community Schools,747,605,242,128,114,14,100,142,19,32,2,13,2021-08-01
1895,Liberty-Perry Community Sch Corp,989,818,383,166,217,5,212,171,17,39,1,21,2021-08-01
1900,Cowan Community School Corp,521,446,344,72,272,3,269,75,14,66,1,52,2021-08-01
1910,Yorktown Community Schools,2351,2082,569,241,328,28,300,269,11,24,1,13,2021-08-01
1940,Daleville Community Schools,623,503,489,116,373,4,369,120,19,78,1,59,2021-08-01
1970,Muncie Community Schools,7069,4587,193,2338,-2145,144,-2289,2482,35,3,2,-32,2021-08-01
2040,Northeast Dubois Co Sch Corp,756,687,79,65,14,4,10,69,9,10,1,1,2021-08-01
2100,Southeast Dubois Co Sch Corp,1169,1104,109,62,47,3,44,65,6,9,0,4,2021-08-01
2110,Southwest Dubois Co Sch Corp,1718,1635,124,80,44,3,41,83,5,7,0,2,2021-08-01
2120,Greater Jasper Consolidated Schs,3247,3027,134,133,1,87,-86,220,7,4,3,-3,2021-08-01
2155,Fairfield Community Schools,2038,1850,306,159,147,29,118,188,9,15,1,6,2021-08-01
2260,Baugo Community Schools,1805,1591,247,174,73,40,33,214,12,14,2,2,2021-08-01
2270,Concord Community Schools,4849,4342,823,409,414,98,316,507,10,17,2,7,2021-08-01
2275,Middlebury Community Schools,4070,3746,495,279,216,45,171,324,8,12,1,4,2021-08-01
2285,Wa-Nee Community Schools,2844,2692,217,124,93,28,65,152,5,8,1,2,2021-08-01
2305,Elkhart Community Schools,13276,11084,371,1798,-1427,394,-1821,2192,17,3,3,-14,2021-08-01
2315,Goshen Community Schools,6738,5933,352,538,-186,267,-453,805,12,5,4,-7,2021-08-01
2395,Fayette County School Corporation,3305,3010,53,222,-169,73,-242,295,9,2,2,-7,2021-08-01
2400,New Albany-Floyd Co Con Sch,11619,10448,922,893,29,278,-249,1171,10,8,2,-2,2021-08-01
2435,Attica Consolidated School Corp,568,512,54,49,5,7,-2,56,10,10,1,-0,2021-08-01
2440,Covington Community School Corp,797,714,80,64,16,19,-3,83,10,10,2,-0,2021-08-01
2455,Southeast Fountain School Corp,1069,947,56,115,-59,7,-66,122,11,5,1,-6,2021-08-01
2475,Franklin County Community Sch Corp,2268,1957,53,251,-198,60,-258,311,14,2,3,-11,2021-08-01
2645,Rochester Community School Corp,1738,1504,156,232,-76,2,-78,234,13,9,0,-4,2021-08-01
2650,Caston School Corporation,689,538,136,151,-15,0,-15,151,22,20,0,-2,2021-08-01
2725,East Gibson School Corporation,899,730,31,160,-129,9,-138,169,19,3,1,-15,2021-08-01
2735,North Gibson School Corporation,2083,1799,78,238,-160,46,-206,284,14,4,2,-10,2021-08-01
2765,South Gibson School Corporation,1924,1740,291,102,189,82,107,184,10,15,4,6,2021-08-01
2815,Eastbrook Community Sch Corp,1340,1225,331,100,231,15,216,115,9,25,1,16,2021-08-01
2825,Madison-Grant United School Corp,1190,988,46,171,-125,31,-156,202,17,4,3,-13,2021-08-01
2855,Mississinewa Community School Corp,1731,1605,681,106,575,20,555,126,7,39,1,32,2021-08-01
2865,Marion Community Schools,5043,3454,54,1350,-1296,239,-1535,1589,32,1,5,-30,2021-08-01
2920,Bloomfield School District,898,751,56,147,-91,0,-91,147,16,6,0,-10,2021-08-01
2940,Eastern Greene Schools,1054,912,137,130,7,12,-5,142,13,13,1,-0,2021-08-01
2950,Linton-Stockton School Corporation,1286,1081,254,205,49,0,49,205,16,20,0,4,2021-08-01
2960,MSD Shakamak Schools,763,594,48,169,-121,0,-121,169,22,6,0,-16,2021-08-01
2980,White River Valley School District,825,629,125,194,-69,2,-71,196,24,15,0,-9,2021-08-01
3005,Hamilton Southeastern Schools,22305,21281,57,696,-639,328,-967,1024,5,0,1,-4,2021-08-01
3025,Hamilton Heights School Corp,2010,1896,299,94,205,20,185,114,6,15,1,9,2021-08-01
3030,Westfield-Washington Schools,8615,8278,80,284,-204,53,-257,337,4,1,1,-3,2021-08-01
3055,Sheridan Community Schools,980,901,114,71,43,8,35,79,8,12,1,4,2021-08-01
3060,Carmel Clay Schools,16355,16019,226,263,-37,73,-110,336,2,1,0,-1,2021-08-01
3070,Noblesville Schools,10978,10205,95,591,-496,182,-678,773,7,1,2,-6,2021-08-01
3115,Southern Hancock Co Com Sch Corp,3191,3004,569,144,425,43,382,187,6,18,1,12,2021-08-01
3125,Greenfield-Central Com Schools,4613,4050,224,503,-279,60,-339,563,12,5,1,-7,2021-08-01
3135,Mt Vernon Community School Corp,4105,3616,644,392,252,97,155,489,12,16,2,4,2021-08-01
3145,Eastern Hancock Co Com Sch Corp,904,783,350,120,230,1,229,121,13,39,0,25,2021-08-01
3160,Lanesville Community School Corp,567,478,243,88,155,1,154,89,16,43,0,27,2021-08-01
3180,North Harrison Com School Corp,2175,1826,258,335,-77,14,-91,349,16,12,1,-4,2021-08-01
3190,South Harrison Com Schools,3222,2833,182,311,-129,78,-207,389,12,6,2,-6,2021-08-01
3295,North West Hendricks Schools,1759,1618,223,104,119,37,82,141,8,13,2,5,2021-08-01
3305,Brownsburg Community School Corp,9775,9241,176,325,-149,209,-358,534,5,2,2,-4,2021-08-01
3315,Avon Community School Corp,10506,9649,163,639,-476,218,-694,857,8,2,2,-7,2021-08-01
3325,Danville Community School Corp,2478,2276,192,172,20,30,-10,202,8,8,1,-0,2021-08-01
3330,Plainfield Community School Corp,5423,5094,434,259,175,70,105,329,6,8,1,2,2021-08-01
3335,Mill Creek Community Sch Corp,1501,1321,147,171,-24,9,-33,180,12,10,1,-2,2021-08-01
3405,Blue River Valley Schools,569,421,159,147,12,1,11,148,26,28,0,2,2021-08-01
3415,South Henry School Corp,648,499,219,148,71,1,70,149,23,34,0,11,2021-08-01
3435,Shenandoah School Corporation,1192,1065,246,117,129,10,119,127,11,21,1,10,2021-08-01
3445,New Castle Community School Corp,3135,2691,209,443,-234,1,-235,444,14,7,0,-7,2021-08-01
3455,C A Beard Memorial School Corp,1304,930,110,371,-261,3,-264,374,29,8,0,-20,2021-08-01
3460,Taylor Community School Corp,1252,746,477,494,-17,12,-29,506,40,38,1,-2,2021-08-01
3470,Northwestern School Corp,1404,1207,593,184,409,13,396,197,14,42,1,28,2021-08-01
3480,Eastern Howard School Corporation,1040,926,578,110,468,4,464,114,11,56,0,45,2021-08-01
3490,Western School Corporation,2326,1999,579,307,272,20,252,327,14,25,1,11,2021-08-01
3500,Kokomo School Corporation,6667,4809,373,1733,-1360,125,-1485,1858,28,6,2,-22,2021-08-01
3625,Huntington Co Com Sch Corp,5396,4847,92,442,-350,107,-457,549,10,2,2,-8,2021-08-01
3640,Medora Community School Corp,209,130,32,77,-45,2,-47,79,38,15,1,-22,2021-08-01
3675,Seymour Community Schools,5466,4987,144,200,-56,279,-335,479,9,3,5,-6,2021-08-01
3695,Brownstown Cnt Com Sch Corp,1434,1308,171,97,74,29,45,126,9,12,2,3,2021-08-01
3710,Crothersville Community Schools,557,437,0,108,-108,12,-120,120,22,0,2,-22,2021-08-01
3785,Kankakee Valley School Corp,3408,3069,81,180,-99,159,-258,339,10,2,5,-8,2021-08-01
3815,Rensselaer Central School Corp,1454,1321,99,103,-4,30,-34,133,9,7,2,-2,2021-08-01
3945,Jay School Corporation,3164,2878,82,198,-116,88,-204,286,9,3,3,-6,2021-08-01
3995,Madison Consolidated Schools,3188,2406,107,524,-417,258,-675,782,25,3,8,-21,2021-08-01
4000,Southwestern-Jefferson Co Con,1196,966,283,183,100,47,53,230,19,24,4,4,2021-08-01
4015,Jennings County School Corporation,4161,3771,109,294,-185,96,-281,390,9,3,2,-7,2021-08-01
4145,Clark-Pleasant Community Sch Corp,7492,6568,164,738,-574,186,-760,924,12,2,2,-10,2021-08-01
4205,Center Grove Community School Corp,9030,8349,456,482,-26,199,-225,681,8,5,2,-2,2021-08-01
4215,Edinburgh Community School Corp,801,659,146,130,16,12,4,142,18,18,1,0,2021-08-01
4225,Franklin Community School Corp,5110,4552,308,441,-133,117,-250,558,11,6,2,-5,2021-08-01
4245,Greenwood Community Sch Corp,3553,3188,723,274,449,91,358,365,10,20,3,10,2021-08-01
4255,Nineveh-Hensley-Jackson United,1724,1518,382,190,192,16,176,206,12,22,1,10,2021-08-01
4315,North Knox School Corp,1452,1227,12,204,-192,21,-213,225,15,1,1,-15,2021-08-01
4325,South Knox School Corp,1057,942,276,88,188,27,161,115,11,26,3,15,2021-08-01
4335,Vincennes Community School Corp,2944,2571,134,273,-139,100,-239,373,13,5,3,-8,2021-08-01
4345,Wawasee Community School Corp,2900,2612,162,276,-114,12,-126,288,10,6,0,-4,2021-08-01
4415,Warsaw Community Schools,6793,6252,411,408,3,133,-130,541,8,6,2,-2,2021-08-01
4445,Tippecanoe Valley School Corp,1847,1569,157,273,-116,5,-121,278,15,9,0,-7,2021-08-01
4455,Whitko Community School Corp,1470,1124,108,330,-222,16,-238,346,24,7,1,-16,2021-08-01
4515,Prairie Heights Community Sch Corp,1263,1083,226,178,48,2,46,180,14,18,0,4,2021-08-01
4525,Westview School Corporation,1929,1793,285,134,151,2,149,136,7,15,0,8,2021-08-01
4535,Lakeland School Corporation,1956,1538,53,415,-362,3,-365,418,21,3,0,-19,2021-08-01
4580,Hanover Community School Corp,2625,2458,29,92,-63,75,-138,167,6,1,3,-5,2021-08-01
4590,River Forest Community Sch Corp,1373,1271,301,78,223,24,199,102,7,22,2,14,2021-08-01
4600,Merrillville Community School Corp,6590,5790,47,529,-482,271,-753,800,12,1,4,-11,2021-08-01
4615,Lake Central School Corporation,9490,9108,62,224,-162,158,-320,382,4,1,2,-3,2021-08-01
4645,Tri-Creek School Corporation,3208,3066,94,97,-3,45,-48,142,4,3,1,-1,2021-08-01
4650,Lake Ridge New Tech Schools,1746,1517,73,146,-73,81,-154,227,13,4,5,-9,2021-08-01
4660,Crown Point Community School Corp,9003,8614,3,212,-209,177,-386,389,4,0,2,-4,2021-08-01
4670,School City of East Chicago,4934,3315,109,1250,-1141,369,-1510,1619,33,2,7,-31,2021-08-01
4680,Lake Station Community Schools,1330,1027,137,245,-108,58,-166,303,23,10,4,-12,2021-08-01
4690,Gary Community School Corp,11432,4445,0,6429,-6429,558,-6987,6987,61,0,5,-61,2021-08-01
4700,Griffith Public Schools,2157,1910,73,180,-107,67,-174,247,11,3,3,-8,2021-08-01
4710,School City of Hammond,13396,11058,648,1372,-724,966,-1690,2338,17,5,7,-13,2021-08-01
4720,School Town of Highland,3208,2992,69,121,-52,95,-147,216,7,2,3,-5,2021-08-01
4730,School City of Hobart,4131,3846,23,225,-202,60,-262,285,7,1,1,-6,2021-08-01
4740,School Town of Munster,3966,3861,185,67,118,38,80,105,3,5,1,2,2021-08-01
4760,School City of Whiting,829,755,379,56,323,18,305,74,9,46,2,37,2021-08-01
4805,New Prairie United School Corp,2450,2240,586,190,396,20,376,210,9,24,1,15,2021-08-01
4860,MSD of New Durham Township,742,592,281,141,140,9,131,150,20,38,1,18,2021-08-01
4915,Tri-Township Cons School Corp,478,242,86,234,-148,2,-150,236,49,18,0,-31,2021-08-01
4925,Michigan City Area Schools,6447,5245,0,814,-814,388,-1202,1202,19,0,6,-19,2021-08-01
4940,South Central Com School Corp,669,568,360,93,267,8,259,101,15,54,1,39,2021-08-01
4945,LaPorte Community School Corp,6169,5537,295,551,-256,81,-337,632,10,5,1,-5,2021-08-01
5075,North Lawrence Com Schools,4616,4147,88,372,-284,97,-381,469,10,2,2,-8,2021-08-01
5085,Mitchell Community Schools,1568,1361,69,202,-133,5,-138,207,13,4,0,-9,2021-08-01
5245,Frankton-Lapel Community Schools,2173,2061,886,92,794,20,774,112,5,41,1,36,2021-08-01
5255,South Madison Com Sch Corp,4026,3795,535,212,323,19,304,231,6,13,0,8,2021-08-01
5265,Alexandria Community School Corp,1484,1241,235,176,59,67,-8,243,16,16,5,-1,2021-08-01
5275,Anderson Community School Corp,9834,6300,32,2870,-2838,664,-3502,3534,36,0,7,-36,2021-08-01
5280,Elwood Community School Corp,1518,1276,79,233,-154,9,-163,242,16,5,1,-11,2021-08-01
5300,MSD Decatur Township,7273,6314,301,749,-448,191,-639,940,13,4,3,-9,2021-08-01
5310,Franklin Township Com Sch Corp,11639,10345,93,804,-711,490,-1201,1294,11,1,4,-10,2021-08-01
5330,MSD Lawrence Township,16273,14116,1361,1453,-92,704,-796,2157,13,8,4,-5,2021-08-01
5340,Perry Township Schools,18406,16075,351,1082,-731,1249,-1980,2331,13,2,7,-11,2021-08-01
5350,MSD Pike Township,12432,10754,34,1051,-1017,627,-1644,1678,13,0,5,-13,2021-08-01
5360,MSD Warren Township,13662,11015,434,1929,-1495,718,-2213,2647,19,3,5,-16,2021-08-01
5370,MSD Washington Township,11349,9956,823,849,-26,544,-570,1393,12,7,5,-5,2021-08-01
5375,MSD Wayne Township,16486,15169,1201,837,364,480,-116,1317,8,7,3,-1,2021-08-01
5380,Beech Grove City Schools,2041,1729,1191,202,989,108,881,310,15,58,5,43,2021-08-01
5385,Indianapolis Public Schools,46072,21127,1149,21221,-20072,3724,-23796,24945,54,2,8,-52,2021-08-01
5400,School Town of Speedway,2010,1777,0,195,-195,38,-233,233,12,0,2,-12,2021-08-01
5455,Culver Community Schools Corp,832,611,123,210,-87,11,-98,221,27,15,1,-12,2021-08-01
5470,Argos Community Schools,627,482,114,141,-27,4,-31,145,23,18,1,-5,2021-08-01
5480,Bremen Public Schools,1250,1197,244,52,192,1,191,53,4,20,0,15,2021-08-01
5485,Plymouth Community School Corp,3252,2899,405,276,129,77,52,353,11,12,2,2,2021-08-01
5495,Triton School Corporation,807,703,139,101,38,3,35,104,13,17,0,4,2021-08-01
5520,Shoals Community School Corp,652,578,32,70,-38,4,-42,74,11,5,1,-6,2021-08-01
5525,Loogootee Community Sch Corp,818,651,110,167,-57,0,-57,167,20,13,0,-7,2021-08-01
5615,Maconaquah School Corp,2123,1704,262,409,-147,10,-157,419,20,12,0,-7,2021-08-01
5620,North Miami Community Schools,786,674,131,112,19,0,19,112,14,17,0,2,2021-08-01
5625,Oak Hill United School Corp,1230,1147,503,67,436,16,420,83,7,41,1,34,2021-08-01
5635,Peru Community Schools,2040,1678,271,362,-91,0,-91,362,18,13,0,-4,2021-08-01
5705,Richland-Bean Blossom C S C,2687,2275,287,357,-70,55,-125,412,15,11,2,-5,2021-08-01
5740,Monroe County Community Sch Corp,11049,9927,331,877,-546,245,-791,1122,10,3,2,-7,2021-08-01
5835,North Montgomery Com Sch Corp,1815,1614,141,192,-51,9,-60,201,11,8,0,-3,2021-08-01
5845,South Montgomery Com Sch Corp,1694,1454,108,238,-130,2,-132,240,14,6,0,-8,2021-08-01
5855,Crawfordsville Community Schools,2363,2149,246,210,36,4,32,214,9,10,0,1,2021-08-01
5900,Monroe-Gregg School District,1366,1219,266,125,141,22,119,147,11,19,2,9,2021-08-01
5910,Eminence Community School Corp,389,276,52,102,-50,11,-61,113,29,13,3,-16,2021-08-01
5925,MSD Martinsville Schools,4544,3729,103,601,-498,214,-712,815,18,2,5,-16,2021-08-01
5930,Mooresville Con School Corp,4108,3634,659,355,304,118,186,473,12,16,3,5,2021-08-01
5945,North Newton School Corp,1257,1118,22,127,-105,12,-117,139,11,2,1,-9,2021-08-01
5995,South Newton School Corp,772,719,70,53,17,0,17,53,7,9,0,2,2021-08-01
6055,Central Noble Com School Corp,1185,1066,142,113,29,6,23,119,10,12,1,2,2021-08-01
6060,East Noble School Corporation,3509,3140,202,287,-85,82,-167,369,11,6,2,-5,2021-08-01
6065,West Noble School Corporation,2228,2028,160,192,-32,8,-40,200,9,7,0,-2,2021-08-01
6080,Rising Sun-Ohio Co Com,807,754,72,46,26,7,19,53,7,9,1,2,2021-08-01
6145,Orleans Community Schools,761,670,181,91,90,0,90,91,12,24,0,12,2021-08-01
6155,Paoli Community School Corp,1252,1118,109,132,-23,2,-25,134,11,9,0,-2,2021-08-01
6160,Springs Valley Com School Corp,846,762,75,84,-9,0,-9,84,10,9,0,-1,2021-08-01
6195,Spencer-Owen Community Schools,2408,1993,105,396,-291,19,-310,415,17,4,1,-13,2021-08-01
6260,Southwest Parke Com Sch Corp,837,750,203,87,116,0,116,87,10,24,0,14,2021-08-01
6325,Perry Central Com Schools Corp,958,850,387,107,280,1,279,108,11,40,0,29,2021-08-01
6340,Cannelton City Schools,293,134,117,159,-42,0,-42,159,54,40,0,-14,2021-08-01
6350,Tell City-Troy Twp School Corp,1630,1218,127,411,-284,1,-285,412,25,8,0,-17,2021-08-01
6375,North Central Parke Comm Schl Corp,1197,1066,93,131,-38,0,-38,131,11,8,0,-3,2021-08-01
6445,Pike County School Corp,1797,1527,50,269,-219,1,-220,270,15,3,0,-12,2021-08-01
6460,MSD Boone Township,1008,922,146,73,73,13,60,86,9,14,1,6,2021-08-01
6470,Duneland School Corporation,5880,5486,298,359,-61,35,-96,394,7,5,1,-2,2021-08-01
6510,East Porter County School Corp,2341,2156,234,166,68,19,49,185,8,10,1,2,2021-08-01
6520,Porter Township School Corp,1363,1262,123,87,36,14,22,101,7,9,1,2,2021-08-01
6530,Union Township School Corp,1446,1342,89,93,-4,11,-15,104,7,6,1,-1,2021-08-01
6550,Portage Township Schools,7633,6960,33,535,-502,138,-640,673,9,0,2,-8,2021-08-01
6560,Valparaiso Community Schools,6579,6101,87,385,-298,93,-391,478,7,1,1,-6,2021-08-01
6590,MSD Mount Vernon,2099,1916,66,103,-37,80,-117,183,9,3,4,-6,2021-08-01
6600,MSD North Posey Co Schools,1416,1254,141,83,58,79,-21,162,11,10,6,-1,2021-08-01
6620,Eastern Pulaski Community Sch Corp,990,923,189,67,122,0,122,67,7,19,0,12,2021-08-01
6630,West Central School Corp,667,601,56,62,-6,4,-10,66,10,8,1,-1,2021-08-01
6705,South Putnam Community Schools,1072,893,153,179,-26,0,-26,179,17,14,0,-2,2021-08-01
6715,North Putnam Community Schools,1431,1194,54,236,-182,1,-183,237,17,4,0,-13,2021-08-01
6750,Cloverdale Community Schools,1031,909,274,118,156,4,152,122,12,27,0,15,2021-08-01
6755,Greencastle Community School Corp,1730,1559,145,168,-23,3,-26,171,10,8,0,-2,2021-08-01
6795,Union School Corporation,370,150,6184,220,5964,0,5964,220,59,1671,0,1612,2021-08-01
6805,Randolph Southern School Corp,431,369,102,61,41,1,40,62,14,24,0,9,2021-08-01
6820,Monroe Central School Corp,849,750,321,96,225,3,222,99,12,38,0,26,2021-08-01
6825,Randolph Central School Corp,1390,1195,120,193,-73,2,-75,195,14,9,0,-5,2021-08-01
6835,Randolph Eastern School Corp,911,843,33,68,-35,0,-35,68,7,4,0,-4,2021-08-01
6865,South Ripley Com Sch Corp,1147,984,105,144,-39,19,-58,163,14,9,2,-5,2021-08-01
6895,Batesville Community School Corp,2014,1830,283,85,198,99,99,184,9,14,5,5,2021-08-01
6900,Jac-Cen-Del Community Sch Corp,815,680,88,125,-37,10,-47,135,17,11,1,-6,2021-08-01
6910,Milan Community Schools,881,737,227,126,101,18,83,144,16,26,2,9,2021-08-01
6995,Rush County Schools,2091,1759,111,283,-172,49,-221,332,16,5,2,-11,2021-08-01
7150,John Glenn School Corporation,1623,1452,527,140,387,31,356,171,11,32,2,22,2021-08-01
7175,Penn-Harris-Madison School Corp,10215,9268,1908,673,1235,274,961,947,9,19,3,9,2021-08-01
7200,School City of Mishawaka,4631,3781,1327,642,685,208,477,850,18,29,4,10,2021-08-01
7205,South Bend Community School Corp,22468,15091,238,4739,-4501,2638,-7139,7377,33,1,12,-32,2021-08-01
7215,Union-North United School Corp,1134,834,417,285,132,15,117,300,26,37,1,10,2021-08-01
7230,Scott County School District 1,1350,1205,0,124,-124,21,-145,145,11,0,2,-11,2021-08-01
7255,Scott County School District 2,2462,2296,256,106,150,60,90,166,7,10,2,4,2021-08-01
7285,Shelby Eastern Schools,1279,960,147,312,-165,7,-172,319,25,11,1,-13,2021-08-01
7350,Northwestern Con School Corp,1214,1092,312,106,206,16,190,122,10,26,1,16,2021-08-01
7360,Southwestern Con Sch Shelby Co,592,446,99,142,-43,4,-47,146,25,17,1,-8,2021-08-01
7365,Shelbyville Central Schools,3830,3484,256,302,-46,44,-90,346,9,7,1,-2,2021-08-01
7385,North Spencer County Sch Corp,1981,1857,93,115,-22,9,-31,124,6,5,0,-2,2021-08-01
7445,South Spencer County Sch Corp,1168,1082,24,49,-25,37,-62,86,7,2,3,-5,2021-08-01
7495,Oregon-Davis School Corp,643,372,118,267,-149,4,-153,271,42,18,1,-24,2021-08-01
7515,North Judson-San Pierre Sch Corp,1172,899,47,212,-165,61,-226,273,23,4,5,-19,2021-08-01
7525,Knox Community School Corp,1698,1450,246,230,16,18,-2,248,15,14,1,-0,2021-08-01
7605,Fremont Community Schools,987,875,84,112,-28,0,-28,112,11,9,0,-3,2021-08-01
7610,Hamilton Community Schools,480,255,65,225,-160,0,-160,225,47,14,0,-33,2021-08-01
7615,MSD Steuben County,2444,2227,287,215,72,2,70,217,9,12,0,3,2021-08-01
7645,Northeast School Corp,1174,651,93,522,-429,1,-430,523,45,8,0,-37,2021-08-01
7715,Southwest School Corporation,1766,1521,206,245,-39,0,-39,245,14,12,0,-2,2021-08-01
7775,Switzerland County School Corp,1523,1408,39,109,-70,6,-76,115,8,3,0,-5,2021-08-01
7855,Lafayette School Corporation,7786,7088,368,271,97,427,-330,698,9,5,5,-4,2021-08-01
7865,Tippecanoe School Corp,14363,13117,232,839,-607,407,-1014,1246,9,2,3,-7,2021-08-01
7875,West Lafayette Com School Corp,2230,2162,146,55,91,13,78,68,3,7,1,3,2021-08-01
7935,Tri-Central Community Schools,632,487,243,144,99,1,98,145,23,38,0,16,2021-08-01
7945,Tipton Community School Corp,1524,1290,122,226,-104,8,-112,234,15,8,1,-7,2021-08-01
7950,Union Co/Clg Corner Joint Sch Dist,1244,1185,88,57,31,2,29,59,5,7,0,2,2021-08-01
7995,Evansville Vanderburgh School Corp,23954,21204,89,1266,-1177,1484,-2661,2750,11,0,6,-11,2021-08-01
8010,North Vermillion Com Sch Corp,661,610,90,50,40,1,39,51,8,14,0,6,2021-08-01
8020,South Vermillion Com Sch Corp,1738,1533,62,199,-137,6,-143,205,12,4,0,-8,2021-08-01
8030,Vigo County School Corp,14165,13249,110,769,-659,147,-806,916,6,1,1,-6,2021-08-01
8045,Manchester Community Schools,1341,1219,141,108,33,14,19,122,9,11,1,1,2021-08-01
8050,MSD Wabash County Schools,1737,1342,736,371,365,24,341,395,23,42,1,20,2021-08-01
8060,Wabash City Schools,1464,1106,347,345,2,13,-11,358,24,24,1,-1,2021-08-01
8115,MSD Warren County,1392,1306,0,85,-85,1,-86,86,6,0,0,-6,2021-08-01
8130,Warrick County School Corp,10348,9714,206,417,-211,217,-428,634,6,2,2,-4,2021-08-01
8205,Salem Community Schools,1958,1596,155,359,-204,3,-207,362,18,8,0,-11,2021-08-01
8215,East Washington School Corp,1396,1181,199,208,-9,7,-16,215,15,14,1,-1,2021-08-01
8220,West Washington School Corp,777,643,231,134,97,0,97,134,17,30,0,12,2021-08-01
8305,Nettle Creek School Corporation,973,819,271,150,121,4,117,154,16,28,0,12,2021-08-01
8355,Western Wayne Schools,842,684,103,155,-52,3,-55,158,19,12,0,-7,2021-08-01
8360,Centerville-Abington Com Schs,1425,1296,435,111,324,18,306,129,9,31,1,21,2021-08-01
8375,Northeastern Wayne Schools,925,831,434,85,349,9,340,94,10,47,1,37,2021-08-01
8385,Richmond Community Schools,5486,4312,91,935,-844,239,-1083,1174,21,2,4,-20,2021-08-01
8425,Southern Wells Com Schools,662,572,259,89,170,1,169,90,14,39,0,26,2021-08-01
8435,Northern Wells Community Schools,2315,1984,436,311,125,20,105,331,14,19,1,5,2021-08-01
8445,MSD Bluffton-Harrison,1505,1324,338,179,159,2,157,181,12,22,0,10,2021-08-01
8515,North White School Corp,965,821,25,144,-119,0,-119,144,15,3,0,-12,2021-08-01
8525,Frontier School Corporation,660,543,75,111,-36,6,-42,117,18,11,1,-6,2021-08-01
8535,Tri-County School Corporation,737,664,62,73,-11,0,-11,73,10,8,0,-1,2021-08-01
8565,Twin Lakes School Corp,2222,2057,116,149,-33,16,-49,165,7,5,1,-2,2021-08-01
8625,Smith-Green Community Schools,1050,963,196,71,125,16,109,87,8,19,2,10,2021-08-01
8665,Whitley County Con Schools,3484,3215,248,209,39,60,-21,269,8,7,2,-1,2021-08-01
0015,Adams Central Community Schools,1053,975,303,66,237,12,225,78,7,29,1,21,2020-08-01
0025,North Adams Community Schools,2032,1583,90,296,-206,153,-359,449,22,4,8,-18,2020-08-01
0035,South Adams Schools,1238,1153,88,82,6,3,3,85,7,7,0,0,2020-08-01
0125,M S D Southwest Allen County Schls,7882,7528,90,121,-31,233,-264,354,4,1,3,-3,2020-08-01
0225,Northwest Allen County Schools,8232,7778,44,226,-182,228,-410,454,6,1,3,-5,2020-08-01
0235,Fort Wayne Community Schools,35164,28507,37,2116,-2079,4541,-6620,6657,19,0,13,-19,2020-08-01
0255,East Allen County Schools,10408,9001,859,385,474,1022,-548,1407,14,8,10,-5,2020-08-01
0365,Bartholomew Con School Corp,11814,10942,310,372,-62,500,-562,872,7,3,4,-5,2020-08-01
0370,Flat Rock-Hawcreek School Corp,872,789,153,77,76,6,70,83,10,18,1,8,2020-08-01
0395,Benton Community School Corp,1836,1675,44,76,-32,85,-117,161,9,2,5,-6,2020-08-01
0515,Blackford County Schools,1795,1542,21,252,-231,1,-232,253,14,1,0,-13,2020-08-01
0615,Western Boone Co Com Sch Dist,1600,1498,182,89,93,13,80,102,6,11,1,5,2020-08-01
0630,Zionsville Community Schools,7221,7081,60,94,-34,46,-80,140,2,1,1,-1,2020-08-01
0665,Lebanon Community School Corp,3614,3320,68,224,-156,70,-226,294,8,2,2,-6,2020-08-01
0670,Brown County School Corporation,1933,1702,58,205,-147,26,-173,231,12,3,1,-9,2020-08-01
0750,Carroll Consolidated School Corp,1060,971,90,82,8,7,1,89,8,8,1,0,2020-08-01
0755,Delphi Community School Corp,1483,1353,29,111,-82,19,-101,130,9,2,1,-7,2020-08-01
0775,Pioneer Regional School Corp,984,917,36,67,-31,0,-31,67,7,4,0,-3,2020-08-01
0815,Lewis Cass Schools,1374,1139,197,233,-36,2,-38,235,17,14,0,-3,2020-08-01
0875,Logansport Community Sch Corp,4273,4050,188,221,-33,2,-35,223,5,4,0,-1,2020-08-01
0940,West Clark Community Schools,4975,4117,423,724,-301,134,-435,858,17,9,3,-9,2020-08-01
1000,Clarksville Community School Corp,1343,955,396,313,83,75,8,388,29,29,6,1,2020-08-01
1010,Greater Clark County Schools,11562,9879,275,1374,-1099,309,-1408,1683,15,2,3,-12,2020-08-01
1125,Clay Community Schools,4076,3894,180,180,0,2,-2,182,4,4,0,-0,2020-08-01
1150,Clinton Central School Corporation,845,727,124,112,12,6,6,118,14,15,1,1,2020-08-01
1160,Clinton Prairie School Corporation,1295,1209,0,63,-63,23,-86,86,7,0,2,-7,2020-08-01
1170,Community Schools of Frankfort,3234,3017,75,193,-118,24,-142,217,7,2,1,-4,2020-08-01
1180,Rossville Con School District,880,828,159,39,120,13,107,52,6,18,1,12,2020-08-01
1300,Crawford County Community Sch Corp,1552,1378,60,171,-111,3,-114,174,11,4,0,-7,2020-08-01
1315,Barr-Reeve Community Schools Inc,774,704,262,69,193,1,192,70,9,34,0,25,2020-08-01
1375,North Daviess Com Schools,1074,1004,168,67,101,3,98,70,7,16,0,9,2020-08-01
1405,Washington Community Schools,2963,2474,32,281,-249,208,-457,489,17,1,7,-15,2020-08-01
1560,Sunman-Dearborn Com Sch Corp,3961,3497,171,364,-193,100,-293,464,12,4,3,-7,2020-08-01
1600,South Dearborn Community Sch Corp,2516,2057,132,390,-258,69,-327,459,18,5,3,-13,2020-08-01
1620,Lawrenceburg Community School Corp,1800,1682,370,105,265,13,252,118,7,21,1,14,2020-08-01
1655,Decatur County Community Schools,1833,1632,293,173,120,28,92,201,11,16,2,5,2020-08-01
1730,Greensburg Community Schools,2353,2116,0,204,-204,33,-237,237,10,0,1,-10,2020-08-01
1805,DeKalb Co Eastern Com Sch Dist,1336,1208,138,111,27,17,10,128,10,10,1,1,2020-08-01
1820,Garrett-Keyser-Butler Com Sch Corp,1652,1500,261,113,148,39,109,152,9,16,2,7,2020-08-01
1835,DeKalb Co Ctl United Sch Dist,3808,3323,181,367,-186,118,-304,485,13,5,3,-8,2020-08-01
1875,Delaware Community School Corp,2518,2223,445,278,167,17,150,295,12,18,1,6,2020-08-01
1885,Wes-Del Community Schools,778,632,208,128,80,18,62,146,19,27,2,8,2020-08-01
1895,Liberty-Perry Community Sch Corp,977,834,370,139,231,4,227,143,15,38,0,23,2020-08-01
1900,Cowan Community School Corp,563,477,322,78,244,8,236,86,15,57,1,42,2020-08-01
1910,Yorktown Community Schools,2384,2147,541,206,335,31,304,237,10,23,1,13,2020-08-01
1940,Daleville Community Schools,641,512,462,113,349,16,333,129,20,72,2,52,2020-08-01
1970,Muncie Community Schools,7147,4709,177,2282,-2105,156,-2261,2438,34,2,2,-32,2020-08-01
2040,Northeast Dubois Co Sch Corp,807,745,72,58,14,4,10,62,8,9,0,1,2020-08-01
2100,Southeast Dubois Co Sch Corp,1173,1120,123,52,71,1,70,53,5,10,0,6,2020-08-01
2110,Southwest Dubois Co Sch Corp,1748,1661,117,84,33,3,30,87,5,7,0,2,2020-08-01
2120,Greater Jasper Consolidated Schs,3252,3049,119,130,-11,73,-84,203,6,4,2,-3,2020-08-01
2155,Fairfield Community Schools,2107,1933,266,149,117,25,92,174,8,13,1,4,2020-08-01
2260,Baugo Community Schools,1845,1660,242,145,97,40,57,185,10,13,2,3,2020-08-01
2270,Concord Community Schools,5009,4531,721,371,350,107,243,478,10,14,2,5,2020-08-01
2275,Middlebury Community Schools,4287,4032,439,196,243,59,184,255,6,10,1,4,2020-08-01
2285,Wa-Nee Community Schools,2983,2843,239,101,138,39,99,140,5,8,1,3,2020-08-01
2305,Elkhart Community Schools,13685,11763,331,1531,-1200,391,-1591,1922,14,2,3,-12,2020-08-01
2315,Goshen Community Schools,6990,6242,334,470,-136,278,-414,748,11,5,4,-6,2020-08-01
2395,Fayette County School Corporation,3406,3127,57,202,-145,77,-222,279,8,2,2,-7,2020-08-01
2400,New Albany-Floyd Co Con Sch,11820,10726,928,794,134,300,-166,1094,9,8,3,-1,2020-08-01
2435,Attica Consolidated School Corp,576,524,48,44,4,8,-4,52,9,8,1,-1,2020-08-01
2440,Covington Community School Corp,852,769,69,63,6,20,-14,83,10,8,2,-2,2020-08-01
2455,Southeast Fountain School Corp,1090,990,57,93,-36,7,-43,100,9,5,1,-4,2020-08-01
2475,Franklin County Community Sch Corp,2372,2116,35,199,-164,57,-221,256,11,1,2,-9,2020-08-01
2645,Rochester Community School Corp,1735,1537,160,196,-36,2,-38,198,11,9,0,-2,2020-08-01
2650,Caston School Corporation,691,570,115,121,-6,0,-6,121,18,17,0,-1,2020-08-01
2725,East Gibson School Corporation,944,767,22,165,-143,12,-155,177,19,2,1,-16,2020-08-01
2735,North Gibson School Corporation,2166,1893,76,204,-128,69,-197,273,13,4,3,-9,2020-08-01
2765,South Gibson School Corporation,1951,1789,290,90,200,72,128,162,8,15,4,7,2020-08-01
2815,Eastbrook Community Sch Corp,1374,1270,315,84,231,20,211,104,8,23,1,15,2020-08-01
2825,Madison-Grant United School Corp,1217,1037,40,149,-109,31,-140,180,15,3,3,-12,2020-08-01
2855,Mississinewa Community School Corp,1850,1691,661,130,531,29,502,159,9,36,2,27,2020-08-01
2865,Marion Community Schools,5042,3510,62,1288,-1226,244,-1470,1532,30,1,5,-29,2020-08-01
2920,Bloomfield School District,911,757,64,154,-90,0,-90,154,17,7,0,-10,2020-08-01
2940,Eastern Greene Schools,1139,998,92,123,-31,18,-49,141,12,8,2,-4,2020-08-01
2950,Linton-Stockton School Corporation,1320,1132,236,188,48,0,48,188,14,18,0,4,2020-08-01
2960,M S D Shakamak Schools,818,666,42,152,-110,0,-110,152,19,5,0,-13,2020-08-01
2980,White River Valley School District,803,626,121,177,-56,0,-56,177,22,15,0,-7,2020-08-01
3005,Hamilton Southeastern Schools,22653,21755,50,585,-535,313,-848,898,4,0,1,-4,2020-08-01
3025,Hamilton Heights School Corp,2118,2000,266,98,168,20,148,118,6,13,1,7,2020-08-01
3030,Westfield-Washington Schools,8537,8261,71,218,-147,58,-205,276,3,1,1,-2,2020-08-01
3055,Sheridan Community Schools,1017,916,108,88,20,13,7,101,10,11,1,1,2020-08-01
3060,Carmel Clay Schools,16599,16306,206,215,-9,78,-87,293,2,1,0,-1,2020-08-01
3070,Noblesville Schools,11111,10392,70,546,-476,173,-649,719,6,1,2,-6,2020-08-01
3115,Southern Hancock Co Com Sch Corp,3299,3123,576,143,433,33,400,176,5,17,1,12,2020-08-01
3125,Greenfield-Central Com Schools,4666,4191,227,404,-177,71,-248,475,10,5,2,-5,2020-08-01
3135,Mt Vernon Community School Corp,4030,3541,665,400,265,89,176,489,12,17,2,4,2020-08-01
3145,Eastern Hancock Co Com Sch Corp,975,873,308,100,208,2,206,102,10,32,0,21,2020-08-01
3160,Lanesville Community School Corp,551,438,297,99,198,14,184,113,21,54,3,33,2020-08-01
3180,North Harrison Com School Corp,2180,1873,254,294,-40,13,-53,307,14,12,1,-2,2020-08-01
3190,South Harrison Com Schools,3410,2949,148,385,-237,76,-313,461,14,4,2,-9,2020-08-01
3295,North West Hendricks Schools,1739,1631,200,80,120,28,92,108,6,12,2,5,2020-08-01
3305,Brownsburg Community School Corp,9590,9147,160,239,-79,204,-283,443,5,2,2,-3,2020-08-01
3315,Avon Community School Corp,10296,9577,187,515,-328,204,-532,719,7,2,2,-5,2020-08-01
3325,Danville Community School Corp,2511,2300,186,171,15,40,-25,211,8,7,2,-1,2020-08-01
3330,Plainfield Community School Corp,5433,5161,399,216,183,56,127,272,5,7,1,2,2020-08-01
3335,Mill Creek Community Sch Corp,1518,1352,142,161,-19,5,-24,166,11,9,0,-2,2020-08-01
3405,Blue River Valley Schools,574,448,164,125,39,1,38,126,22,29,0,7,2020-08-01
3415,South Henry School Corp,643,519,218,122,96,2,94,124,19,34,0,15,2020-08-01
3435,Shenandoah School Corporation,1238,1109,235,118,117,11,106,129,10,19,1,9,2020-08-01
3445,New Castle Community School Corp,3273,2852,204,418,-214,3,-217,421,13,6,0,-7,2020-08-01
3455,C A Beard Memorial School Corp,1316,930,73,384,-311,2,-313,386,29,6,0,-24,2020-08-01
3460,Taylor Community School Corp,1333,834,413,483,-70,16,-86,499,37,31,1,-6,2020-08-01
3470,Northwestern School Corp,1430,1247,604,172,432,11,421,183,13,42,1,29,2020-08-01
3480,Eastern Howard School Corporation,1104,1014,552,90,462,0,462,90,8,50,0,42,2020-08-01
3490,Western School Corporation,2356,2040,606,293,313,23,290,316,13,26,1,12,2020-08-01
3500,Kokomo School Corporation,6865,5076,385,1631,-1246,158,-1404,1789,26,6,2,-20,2020-08-01
3625,Huntington Co Com Sch Corp,5434,4936,62,397,-335,101,-436,498,9,1,2,-8,2020-08-01
3640,Medora Community School Corp,189,107,34,80,-46,2,-48,82,43,18,1,-25,2020-08-01
3675,Seymour Community Schools,5502,5046,137,181,-44,275,-319,456,8,2,5,-6,2020-08-01
3695,Brownstown Cnt Com Sch Corp,1520,1384,187,112,75,24,51,136,9,12,2,3,2020-08-01
3710,Crothersville Community Schools,521,420,0,93,-93,8,-101,101,19,0,2,-19,2020-08-01
3785,Kankakee Valley School Corp,3575,3273,88,129,-41,173,-214,302,8,2,5,-6,2020-08-01
3815,Rensselaer Central School Corp,1558,1449,98,82,16,27,-11,109,7,6,2,-1,2020-08-01
3945,Jay School Corporation,3290,3062,82,179,-97,49,-146,228,7,2,1,-4,2020-08-01
3995,Madison Consolidated Schools,3242,2500,68,503,-435,239,-674,742,23,2,7,-21,2020-08-01
4000,Southwestern-Jefferson Co Con,1194,1009,253,134,119,51,68,185,15,21,4,6,2020-08-01
4015,Jennings County School Corporation,4388,4036,96,246,-150,106,-256,352,8,2,2,-6,2020-08-01
4145,Clark-Pleasant Community Sch Corp,7474,6655,92,606,-514,213,-727,819,11,1,3,-10,2020-08-01
4205,Center Grove Community School Corp,8942,8336,414,401,13,205,-192,606,7,5,2,-2,2020-08-01
4215,Edinburgh Community School Corp,787,656,158,116,42,15,27,131,17,20,2,3,2020-08-01
4225,Franklin Community School Corp,5178,4697,337,343,-6,138,-144,481,9,7,3,-3,2020-08-01
4245,Greenwood Community Sch Corp,3675,3317,675,243,432,115,317,358,10,18,3,9,2020-08-01
4255,Nineveh-Hensley-Jackson United,1761,1572,369,171,198,18,180,189,11,21,1,10,2020-08-01
4315,North Knox School Corp,1489,1293,17,169,-152,27,-179,196,13,1,2,-12,2020-08-01
4325,South Knox School Corp,1074,987,269,66,203,21,182,87,8,25,2,17,2020-08-01
4335,Vincennes Community School Corp,2969,2593,121,267,-146,109,-255,376,13,4,4,-9,2020-08-01
4345,Wawasee Community School Corp,2957,2729,169,212,-43,16,-59,228,8,6,1,-2,2020-08-01
4415,Warsaw Community Schools,6997,6547,388,305,83,145,-62,450,6,6,2,-1,2020-08-01
4445,Tippecanoe Valley School Corp,1884,1635,131,242,-111,7,-118,249,13,7,0,-6,2020-08-01
4455,Whitko Community School Corp,1530,1197,93,314,-221,19,-240,333,22,6,1,-16,2020-08-01
4515,Prairie Heights Community Sch Corp,1309,1139,225,168,57,2,55,170,13,17,0,4,2020-08-01
4525,Westview School Corporation,2124,2012,272,105,167,7,160,112,5,13,0,8,2020-08-01
4535,Lakeland School Corporation,2026,1635,51,388,-337,3,-340,391,19,3,0,-17,2020-08-01
4580,Hanover Community School Corp,2564,2403,17,80,-63,81,-144,161,6,1,3,-6,2020-08-01
4590,River Forest Community Sch Corp,1396,1342,250,40,210,14,196,54,4,18,1,14,2020-08-01
4600,Merrillville Community School Corp,6879,6097,63,499,-436,282,-718,781,11,1,4,-10,2020-08-01
4615,Lake Central School Corporation,9638,9328,86,152,-66,158,-224,310,3,1,2,-2,2020-08-01
4645,Tri-Creek School Corporation,3275,3149,102,89,13,37,-24,126,4,3,1,-1,2020-08-01
4650,Lake Ridge New Tech Schools,1845,1655,60,115,-55,74,-129,189,10,3,4,-7,2020-08-01
4660,Crown Point Community School Corp,9008,8724,1,139,-138,145,-283,284,3,0,2,-3,2020-08-01
4670,School City of East Chicago,5210,3640,67,1207,-1140,363,-1503,1570,30,1,7,-29,2020-08-01
4680,Lake Station Community Schools,1389,1129,108,196,-88,64,-152,260,19,8,5,-11,2020-08-01
4690,Gary Community School Corp,11952,4352,0,7051,-7051,549,-7600,7600,64,0,5,-64,2020-08-01
4700,Griffith Public Schools,2313,2168,86,88,-2,57,-59,145,6,4,2,-3,2020-08-01
4710,School City of Hammond,13802,11620,595,1235,-640,947,-1587,2182,16,4,7,-11,2020-08-01
4720,School Town of Highland,3328,3146,63,87,-24,95,-119,182,5,2,3,-4,2020-08-01
4730,School City of Hobart,4253,3987,11,190,-179,75,-254,265,6,0,2,-6,2020-08-01
4740,School Town of Munster,3996,3938,198,20,178,38,140,58,1,5,1,4,2020-08-01
4760,School City of Whiting,897,812,376,57,319,28,291,85,9,42,3,32,2020-08-01
4805,New Prairie United School Corp,2545,2377,563,154,409,14,395,168,7,22,1,16,2020-08-01
4860,M S D of New Durham Township,768,626,247,136,111,6,105,142,18,32,1,14,2020-08-01
4915,Tri-Township Cons School Corp,483,268,64,213,-149,2,-151,215,45,13,0,-31,2020-08-01
4925,Michigan City Area Schools,6603,5424,0,770,-770,409,-1179,1179,18,0,6,-18,2020-08-01
4940,South Central Com School Corp,682,618,304,61,243,3,240,64,9,45,0,35,2020-08-01
4945,LaPorte Community School Corp,6377,5838,274,447,-173,92,-265,539,8,4,1,-4,2020-08-01
5075,North Lawrence Com Schools,4827,4480,126,263,-137,84,-221,347,7,3,2,-5,2020-08-01
5085,Mitchell Community Schools,1643,1453,46,183,-137,7,-144,190,12,3,0,-9,2020-08-01
5245,Frankton-Lapel Community Schools,2284,2196,820,74,746,14,732,88,4,36,1,32,2020-08-01
5255,South Madison Com Sch Corp,4041,3814,521,206,315,21,294,227,6,13,1,7,2020-08-01
5265,Alexandria Community School Corp,1592,1382,225,147,78,63,15,210,13,14,4,1,2020-08-01
5275,Anderson Community School Corp,10011,6551,25,2746,-2721,714,-3435,3460,35,0,7,-34,2020-08-01
5280,Elwood Community School Corp,1535,1312,65,213,-148,10,-158,223,15,4,1,-10,2020-08-01
5300,M S D Decatur Township,7254,6379,250,670,-420,190,-610,860,12,3,3,-8,2020-08-01
5310,Franklin Township Com Sch Corp,11226,10023,110,682,-572,521,-1093,1203,11,1,5,-10,2020-08-01
5330,M S D Lawrence Township,16524,14396,1299,1411,-112,717,-829,2128,13,8,4,-5,2020-08-01
5340,Perry Township Schools,18399,16342,328,914,-586,1143,-1729,2057,11,2,6,-9,2020-08-01
5350,M S D Pike Township,12806,11254,0,947,-947,605,-1552,1552,12,0,5,-12,2020-08-01
5360,M S D Warren Township,14182,11592,0,1831,-1831,759,-2590,2590,18,0,5,-18,2020-08-01
5370,M S D Washington Township,11536,10238,823,751,72,547,-475,1298,11,7,5,-4,2020-08-01
5375,M S D Wayne Township,16944,15811,1088,745,343,388,-45,1133,7,6,2,-0,2020-08-01
5380,Beech Grove City Schools,2181,1875,1062,185,877,121,756,306,14,49,6,35,2020-08-01
5385,Indianapolis Public Schools,46855,23767,940,19244,-18304,3844,-22148,23088,49,2,8,-47,2020-08-01
5400,School Town of Speedway,2082,1857,0,183,-183,42,-225,225,11,0,2,-11,2020-08-01
5455,Culver Community Schools Corp,876,643,125,225,-100,8,-108,233,27,14,1,-12,2020-08-01
5470,Argos Community Schools,605,456,114,145,-31,4,-35,149,25,19,1,-6,2020-08-01
5480,Bremen Public Schools,1293,1231,232,59,173,3,170,62,5,18,0,13,2020-08-01
5485,Plymouth Community School Corp,3349,3011,407,249,158,89,69,338,10,12,3,2,2020-08-01
5495,Triton School Corporation,864,767,141,97,44,0,44,97,11,16,0,5,2020-08-01
5520,Shoals Community School Corp,649,582,33,66,-33,1,-34,67,10,5,0,-5,2020-08-01
5525,Loogootee Community Sch Corp,846,683,110,163,-53,0,-53,163,19,13,0,-6,2020-08-01
5615,Maconaquah School Corp,2066,1754,322,301,21,11,10,312,15,16,1,0,2020-08-01
5620,North Miami Community Schools,855,759,77,96,-19,0,-19,96,11,9,0,-2,2020-08-01
5625,Oak Hill United School Corp,1290,1213,484,63,421,14,407,77,6,38,1,32,2020-08-01
5635,Peru Community Schools,2105,1749,183,355,-172,1,-173,356,17,9,0,-8,2020-08-01
5705,Richland-Bean Blossom C S C,2756,2371,290,332,-42,53,-95,385,14,11,2,-3,2020-08-01
5740,Monroe County Community Sch Corp,11587,10583,313,747,-434,257,-691,1004,9,3,2,-6,2020-08-01
5835,North Montgomery Com Sch Corp,1832,1634,145,195,-50,3,-53,198,11,8,0,-3,2020-08-01
5845,South Montgomery Com Sch Corp,1733,1520,112,210,-98,3,-101,213,12,6,0,-6,2020-08-01
5855,Crawfordsville Community Schools,2444,2243,249,201,48,0,48,201,8,10,0,2,2020-08-01
5900,Monroe-Gregg School District,1388,1239,246,116,130,31,99,147,11,18,2,7,2020-08-01
5910,Eminence Community School Corp,411,299,43,107,-64,5,-69,112,27,10,1,-17,2020-08-01
5925,M S D Martinsville Schools,4806,4133,95,450,-355,223,-578,673,14,2,5,-12,2020-08-01
5930,Mooresville Con School Corp,4146,3704,650,314,336,127,209,441,11,16,3,5,2020-08-01
5945,North Newton School Corp,1259,1132,24,109,-85,18,-103,127,10,2,1,-8,2020-08-01
5995,South Newton School Corp,852,801,20,49,-29,2,-31,51,6,2,0,-4,2020-08-01
6055,Central Noble Com School Corp,1250,1119,144,127,17,4,13,131,10,12,0,1,2020-08-01
6060,East Noble School Corporation,3608,3273,236,240,-4,95,-99,335,9,7,3,-3,2020-08-01
6065,West Noble School Corporation,2312,2130,138,174,-36,8,-44,182,8,6,0,-2,2020-08-01
6080,Rising Sun-Ohio Co Com,808,743,78,60,18,5,13,65,8,10,1,2,2020-08-01
6145,Orleans Community Schools,768,704,149,64,85,0,85,64,8,19,0,11,2020-08-01
6155,Paoli Community School Corp,1393,1266,62,123,-61,4,-65,127,9,4,0,-5,2020-08-01
6160,Springs Valley Com School Corp,881,810,66,71,-5,0,-5,71,8,7,0,-1,2020-08-01
6195,Spencer-Owen Community Schools,2583,2181,89,375,-286,27,-313,402,16,3,1,-12,2020-08-01
6260,Southwest Parke Com Sch Corp,821,769,217,52,165,0,165,52,6,26,0,20,2020-08-01
6325,Perry Central Com Schools Corp,922,817,366,102,264,3,261,105,11,40,0,28,2020-08-01
6340,Cannelton City Schools,303,159,93,144,-51,0,-51,144,48,31,0,-17,2020-08-01
6350,Tell City-Troy Twp School Corp,1649,1252,131,397,-266,0,-266,397,24,8,0,-16,2020-08-01
6375,North Central Parke Comm Schl Corp,1173,1047,69,126,-57,0,-57,126,11,6,0,-5,2020-08-01
6445,Pike County School Corp,1837,1626,59,208,-149,3,-152,211,11,3,0,-8,2020-08-01
6460,M S D Boone Township,1045,984,152,48,104,13,91,61,6,15,1,9,2020-08-01
6470,Duneland School Corporation,5924,5531,327,367,-40,26,-66,393,7,6,0,-1,2020-08-01
6510,East Porter County School Corp,2384,2218,243,138,105,28,77,166,7,10,1,3,2020-08-01
6520,Porter Township School Corp,1435,1348,124,72,52,15,37,87,6,9,1,3,2020-08-01
6530,Union Township School Corp,1457,1370,87,77,10,10,0,87,6,6,1,0,2020-08-01
6550,Portage Township Schools,7965,7293,28,520,-492,152,-644,672,8,0,2,-8,2020-08-01
6560,Valparaiso Community Schools,6659,6183,74,354,-280,122,-402,476,7,1,2,-6,2020-08-01
6590,M S D Mount Vernon,2113,1951,64,95,-31,67,-98,162,8,3,3,-5,2020-08-01
6600,M S D North Posey Co Schools,1430,1293,113,60,53,77,-24,137,10,8,5,-2,2020-08-01
6620,Eastern Pulaski Community Sch Corp,1073,1009,181,64,117,0,117,64,6,17,0,11,2020-08-01
6630,West Central School Corp,725,668,66,53,13,4,9,57,8,9,1,1,2020-08-01
6705,South Putnam Community Schools,1087,943,137,143,-6,1,-7,144,13,13,0,-1,2020-08-01
6715,North Putnam Community Schools,1491,1277,42,212,-170,2,-172,214,14,3,0,-12,2020-08-01
6750,Cloverdale Community Schools,1074,971,84,99,-15,4,-19,103,10,8,0,-2,2020-08-01
6755,Greencastle Community School Corp,1824,1664,126,159,-33,1,-34,160,9,7,0,-2,2020-08-01
6795,Union School Corporation,377,173,4223,204,4019,0,4019,204,54,1120,0,1066,2020-08-01
6805,Randolph Southern School Corp,459,397,91,60,31,2,29,62,14,20,0,6,2020-08-01
6820,Monroe Central School Corp,887,802,258,85,173,0,173,85,10,29,0,20,2020-08-01
6825,Randolph Central School Corp,1407,1249,118,156,-38,2,-40,158,11,8,0,-3,2020-08-01
6835,Randolph Eastern School Corp,906,831,39,75,-36,0,-36,75,8,4,0,-4,2020-08-01
6865,South Ripley Com Sch Corp,1203,1035,119,146,-27,22,-49,168,14,10,2,-4,2020-08-01
6895,Batesville Community School Corp,2041,1880,300,62,238,99,139,161,8,15,5,7,2020-08-01
6900,Jac-Cen-Del Community Sch Corp,855,718,88,136,-48,1,-49,137,16,10,0,-6,2020-08-01
6910,Milan Community Schools,954,801,229,132,97,21,76,153,16,24,2,8,2020-08-01
6995,Rush County Schools,2187,1847,114,286,-172,54,-226,340,16,5,2,-10,2020-08-01
7150,John Glenn School Corporation,1650,1491,514,144,370,15,355,159,10,31,1,22,2020-08-01
7175,Penn-Harris-Madison School Corp,10216,9438,1826,489,1337,289,1048,778,8,18,3,10,2020-08-01
7200,School City of Mishawaka,4834,4076,1088,536,552,222,330,758,16,23,5,7,2020-08-01
7205,South Bend Community School Corp,23069,15847,55,4479,-4424,2743,-7167,7222,31,0,12,-31,2020-08-01
7215,Union-North United School Corp,1117,842,437,265,172,10,162,275,25,39,1,15,2020-08-01
7230,Scott County School District 1,1370,1214,1,137,-136,19,-155,156,11,0,1,-11,2020-08-01
7255,Scott County School District 2,2498,2336,256,103,153,59,94,162,6,10,2,4,2020-08-01
7285,Shelby Eastern Schools,1267,953,151,306,-155,8,-163,314,25,12,1,-13,2020-08-01
7350,Northwestern Con School Corp,1276,1172,319,79,240,25,215,104,8,25,2,17,2020-08-01
7360,Southwestern Con Sch Shelby Co,599,462,91,131,-40,6,-46,137,23,15,1,-8,2020-08-01
7365,Shelbyville Central Schools,3992,3687,201,253,-52,52,-104,305,8,5,1,-3,2020-08-01
7385,North Spencer County Sch Corp,1978,1865,81,106,-25,7,-32,113,6,4,0,-2,2020-08-01
7445,South Spencer County Sch Corp,1217,1135,21,32,-11,50,-61,82,7,2,4,-5,2020-08-01
7495,Oregon-Davis School Corp,659,373,125,284,-159,2,-161,286,43,19,0,-24,2020-08-01
7515,North Judson-San Pierre Sch Corp,1221,955,28,209,-181,57,-238,266,22,2,5,-19,2020-08-01
7525,Knox Community School Corp,1756,1530,239,205,34,21,13,226,13,14,1,1,2020-08-01
7605,Fremont Community Schools,944,851,124,93,31,0,31,93,10,13,0,3,2020-08-01
7610,Hamilton Community Schools,473,249,48,224,-176,0,-176,224,47,10,0,-37,2020-08-01
7615,M S D Steuben County,2625,2365,302,255,47,5,42,260,10,12,0,2,2020-08-01
7645,Northeast School Corp,1222,712,83,508,-425,2,-427,510,42,7,0,-35,2020-08-01
7715,Southwest School Corporation,1762,1550,195,212,-17,0,-17,212,12,11,0,-1,2020-08-01
7775,Switzerland County School Corp,1529,1404,45,118,-73,7,-80,125,8,3,0,-5,2020-08-01
7855,Lafayette School Corporation,8143,7460,309,249,60,434,-374,683,8,4,5,-5,2020-08-01
7865,Tippecanoe School Corp,14355,13281,248,656,-408,418,-826,1074,7,2,3,-6,2020-08-01
7875,West Lafayette Com School Corp,2297,2256,130,34,96,7,89,41,2,6,0,4,2020-08-01
7935,Tri-Central Community Schools,663,538,223,122,101,3,98,125,19,34,0,15,2020-08-01
7945,Tipton Community School Corp,1580,1354,124,220,-96,6,-102,226,14,8,0,-6,2020-08-01
7950,Union Co/Clg Corner Joint Sch Dist,1235,1191,86,44,42,0,42,44,4,7,0,3,2020-08-01
7995,Evansville Vanderburgh School Corp,24582,21915,102,1028,-926,1639,-2565,2667,11,0,7,-10,2020-08-01
8010,North Vermillion Com Sch Corp,694,655,95,38,57,1,56,39,6,14,0,8,2020-08-01
8020,South Vermillion Com Sch Corp,1773,1602,61,165,-104,6,-110,171,10,3,0,-6,2020-08-01
8030,Vigo County School Corp,14792,14086,98,551,-453,155,-608,706,5,1,1,-4,2020-08-01
8045,Manchester Community Schools,1458,1363,160,81,79,14,65,95,7,11,1,4,2020-08-01
8050,M S D Wabash County Schools,1761,1388,684,352,332,21,311,373,21,39,1,18,2020-08-01
8060,Wabash City Schools,1555,1170,336,364,-28,21,-49,385,25,22,1,-3,2020-08-01
8115,M S D Warren County,1394,1320,0,72,-72,2,-74,74,5,0,0,-5,2020-08-01
8130,Warrick County School Corp,10416,9896,190,301,-111,219,-330,520,5,2,2,-3,2020-08-01
8205,Salem Community Schools,1944,1652,146,291,-145,1,-146,292,15,8,0,-8,2020-08-01
8215,East Washington School Corp,1489,1295,116,188,-72,6,-78,194,13,8,0,-5,2020-08-01
8220,West Washington School Corp,776,655,217,120,97,1,96,121,16,28,0,12,2020-08-01
8305,Nettle Creek School Corporation,1005,868,241,135,106,2,104,137,14,24,0,10,2020-08-01
8355,Western Wayne Schools,879,730,95,146,-51,3,-54,149,17,11,0,-6,2020-08-01
8360,Centerville-Abington Com Schs,1437,1321,425,91,334,25,309,116,8,30,2,22,2020-08-01
8375,Northeastern Wayne Schools,945,865,426,73,353,7,346,80,8,45,1,37,2020-08-01
8385,Richmond Community Schools,5605,4502,92,858,-766,245,-1011,1103,20,2,4,-18,2020-08-01
8425,Southern Wells Com Schools,652,574,298,78,220,0,220,78,12,46,0,34,2020-08-01
8435,Northern Wells Community Schools,2380,2078,408,274,134,28,106,302,13,17,1,4,2020-08-01
8445,M S D Bluffton-Harrison,1534,1353,293,179,114,2,112,181,12,19,0,7,2020-08-01
8515,North White School Corp,1021,868,19,153,-134,0,-134,153,15,2,0,-13,2020-08-01
8525,Frontier School Corporation,674,574,75,93,-18,7,-25,100,15,11,1,-4,2020-08-01
8535,Tri-County School Corporation,687,624,71,62,9,1,8,63,9,10,0,1,2020-08-01
8565,Twin Lakes School Corp,2304,2210,114,80,34,14,20,94,4,5,1,1,2020-08-01
8625,Smith-Green Community Schools,1054,972,191,65,126,17,109,82,8,18,2,10,2020-08-01
8665,Whitley County Con Schools,3582,3354,214,161,53,67,-14,228,6,6,2,-0,2020-08-01
0015,Adams Central Community Schools,1075,980,305,80,225,15,210,95,9,28,1,20,2019-08-01
0025,North Adams Community Schools,2043,1591,84,284,-200,168,-368,452,22,4,8,-18,2019-08-01
0035,South Adams Schools,1146,1047,89,98,-9,1,-10,99,9,8,0,-1,2019-08-01
0125,M S D Southwest Allen County Schls,7726,7336,86,138,-52,252,-304,390,5,1,3,-4,2019-08-01
0225,Northwest Allen County Schools,8080,7589,50,266,-216,225,-441,491,6,1,3,-5,2019-08-01
0235,Fort Wayne Community Schools,34959,28320,20,2121,-2101,4518,-6619,6639,19,0,13,-19,2019-08-01
0255,East Allen County Schools,10408,8990,723,413,310,1005,-695,1418,14,7,10,-7,2019-08-01
0365,Bartholomew Con School Corp,11746,10865,322,417,-95,464,-559,881,8,3,4,-5,2019-08-01
0370,Flat Rock-Hawcreek School Corp,855,767,131,78,53,10,43,88,10,15,1,5,2019-08-01
0395,Benton Community School Corp,1841,1678,44,91,-47,72,-119,163,9,2,4,-6,2019-08-01
0515,Blackford County Schools,1804,1548,33,256,-223,0,-223,256,14,2,0,-12,2019-08-01
0615,Western Boone Co Com Sch Dist,1612,1520,142,88,54,4,50,92,6,9,0,3,2019-08-01
0630,Zionsville Community Schools,7021,6890,39,82,-43,49,-92,131,2,1,1,-1,2019-08-01
0665,Lebanon Community School Corp,3628,3331,60,219,-159,78,-237,297,8,2,2,-7,2019-08-01
0670,Brown County School Corporation,1930,1705,45,202,-157,23,-180,225,12,2,1,-9,2019-08-01
0750,Carroll Consolidated School Corp,1048,953,83,89,-6,6,-12,95,9,8,1,-1,2019-08-01
0755,Delphi Community School Corp,1485,1343,35,124,-89,18,-107,142,10,2,1,-7,2019-08-01
0775,Pioneer Regional School Corp,970,885,43,85,-42,0,-42,85,9,4,0,-4,2019-08-01
0815,Lewis Cass Schools,1364,1141,181,220,-39,3,-42,223,16,13,0,-3,2019-08-01
0875,Logansport Community Sch Corp,4257,3981,168,274,-106,2,-108,276,6,4,0,-3,2019-08-01
0940,West Clark Community Schools,4911,4113,428,649,-221,149,-370,798,16,9,3,-8,2019-08-01
1000,Clarksville Community School Corp,1407,971,377,349,28,87,-59,436,31,27,6,-4,2019-08-01
1010,Greater Clark County Schools,11421,9778,248,1341,-1093,302,-1395,1643,14,2,3,-12,2019-08-01
1125,Clay Community Schools,4020,3839,176,178,-2,3,-5,181,5,4,0,-0,2019-08-01
1150,Clinton Central School Corporation,853,757,112,93,19,3,16,96,11,13,0,2,2019-08-01
1160,Clinton Prairie School Corporation,1292,1224,3,51,-48,17,-65,68,5,0,1,-5,2019-08-01
1170,Community Schools of Frankfort,3228,3010,61,190,-129,28,-157,218,7,2,1,-5,2019-08-01
1180,Rossville Con School District,879,826,132,48,84,5,79,53,6,15,1,9,2019-08-01
1300,Crawford County Community Sch Corp,1578,1413,10,165,-155,0,-155,165,10,1,0,-10,2019-08-01
1315,Barr-Reeve Community Schools Inc,741,679,239,60,179,2,177,62,8,32,0,24,2019-08-01
1375,North Daviess Com Schools,1080,1022,154,54,100,4,96,58,5,14,0,9,2019-08-01
1405,Washington Community Schools,3023,2520,1,294,-293,209,-502,503,17,0,7,-17,2019-08-01
1560,Sunman-Dearborn Com Sch Corp,3888,3466,159,349,-190,73,-263,422,11,4,2,-7,2019-08-01
1600,South Dearborn Community Sch Corp,2635,2159,138,396,-258,80,-338,476,18,5,3,-13,2019-08-01
1620,Lawrenceburg Community School Corp,1793,1686,342,94,248,13,235,107,6,19,1,13,2019-08-01
1655,Decatur County Community Schools,1842,1666,266,153,113,23,90,176,10,14,1,5,2019-08-01
1730,Greensburg Community Schools,2325,2091,0,200,-200,34,-234,234,10,0,1,-10,2019-08-01
1805,DeKalb Co Eastern Com Sch Dist,1334,1216,107,97,10,21,-11,118,9,8,2,-1,2019-08-01
1820,Garrett-Keyser-Butler Com Sch Corp,1650,1500,220,103,117,47,70,150,9,13,3,4,2019-08-01
1835,DeKalb Co Ctl United Sch Dist,3832,3351,170,358,-188,123,-311,481,13,4,3,-8,2019-08-01
1875,Delaware Community School Corp,2542,2253,393,283,110,6,104,289,11,15,0,4,2019-08-01
1885,Wes-Del Community Schools,798,654,192,127,65,17,48,144,18,24,2,6,2019-08-01
1895,Liberty-Perry Community Sch Corp,858,733,462,121,341,4,337,125,15,54,0,39,2019-08-01
1900,Cowan Community School Corp,588,507,298,79,219,2,217,81,14,51,0,37,2019-08-01
1910,Yorktown Community Schools,2394,2138,495,231,264,25,239,256,11,21,1,10,2019-08-01
1940,Daleville Community Schools,622,509,440,103,337,10,327,113,18,71,2,53,2019-08-01
1970,Muncie Community Schools,7177,4759,180,2255,-2075,163,-2238,2418,34,3,2,-31,2019-08-01
2040,Northeast Dubois Co Sch Corp,798,750,71,48,23,0,23,48,6,9,0,3,2019-08-01
2100,Southeast Dubois Co Sch Corp,1168,1126,123,42,81,0,81,42,4,11,0,7,2019-08-01
2110,Southwest Dubois Co Sch Corp,1735,1637,87,92,-5,6,-11,98,6,5,0,-1,2019-08-01
2120,Greater Jasper Consolidated Schs,3239,3032,107,125,-18,82,-100,207,6,3,3,-3,2019-08-01
2155,Fairfield Community Schools,2074,1916,232,128,104,30,74,158,8,11,1,4,2019-08-01
2260,Baugo Community Schools,1816,1622,232,152,80,42,38,194,11,13,2,2,2019-08-01
2270,Concord Community Schools,4985,4562,764,342,422,81,341,423,8,15,2,7,2019-08-01
2275,Middlebury Community Schools,4356,4076,449,203,246,77,169,280,6,10,2,4,2019-08-01
2285,Wa-Nee Community Schools,2956,2804,214,122,92,30,62,152,5,7,1,2,2019-08-01
2305,Elkhart Community Schools,13845,11803,310,1643,-1333,399,-1732,2042,15,2,3,-13,2019-08-01
2315,Goshen Community Schools,6927,6232,291,450,-159,245,-404,695,10,4,4,-6,2019-08-01
2395,Fayette County School Corporation,3417,3143,56,193,-137,81,-218,274,8,2,2,-6,2019-08-01
2400,New Albany-Floyd Co Con Sch,11793,10670,829,821,8,302,-294,1123,10,7,3,-2,2019-08-01
2435,Attica Consolidated School Corp,603,550,39,45,-6,8,-14,53,9,6,1,-2,2019-08-01
2440,Covington Community School Corp,855,768,73,61,12,26,-14,87,10,9,3,-2,2019-08-01
2455,Southeast Fountain School Corp,1054,964,57,90,-33,0,-33,90,9,5,0,-3,2019-08-01
2475,Franklin County Community Sch Corp,2394,2139,27,204,-177,51,-228,255,11,1,2,-10,2019-08-01
2645,Rochester Community School Corp,1731,1530,152,199,-47,2,-49,201,12,9,0,-3,2019-08-01
2650,Caston School Corporation,645,526,129,119,10,0,10,119,18,20,0,2,2019-08-01
2725,East Gibson School Corporation,974,806,20,156,-136,12,-148,168,17,2,1,-15,2019-08-01
2735,North Gibson School Corporation,2165,1888,63,211,-148,66,-214,277,13,3,3,-10,2019-08-01
2765,South Gibson School Corporation,1913,1745,276,101,175,67,108,168,9,14,4,6,2019-08-01
2815,Eastbrook Community Sch Corp,1382,1272,317,92,225,18,207,110,8,23,1,15,2019-08-01
2825,Madison-Grant United School Corp,1227,1049,35,147,-112,31,-143,178,15,3,3,-12,2019-08-01
2855,Mississinewa Community School Corp,1832,1686,616,112,504,34,470,146,8,34,2,26,2019-08-01
2865,Marion Community Schools,5069,3499,48,1371,-1323,199,-1522,1570,31,1,4,-30,2019-08-01
2920,Bloomfield School District,911,745,62,164,-102,2,-104,166,18,7,0,-11,2019-08-01
2940,Eastern Greene Schools,1165,1043,79,103,-24,19,-43,122,10,7,2,-4,2019-08-01
2950,Linton-Stockton School Corporation,1295,1107,234,188,46,0,46,188,15,18,0,4,2019-08-01
2960,M S D Shakamak Schools,824,704,37,120,-83,0,-83,120,15,4,0,-10,2019-08-01
2980,White River Valley School District,796,622,123,174,-51,0,-51,174,22,15,0,-6,2019-08-01
3005,Hamilton Southeastern Schools,22400,21470,42,651,-609,279,-888,930,4,0,1,-4,2019-08-01
3025,Hamilton Heights School Corp,2123,2018,202,87,115,18,97,105,5,10,1,5,2019-08-01
3030,Westfield-Washington Schools,8263,7996,75,221,-146,46,-192,267,3,1,1,-2,2019-08-01
3055,Sheridan Community Schools,1037,923,92,102,-10,12,-22,114,11,9,1,-2,2019-08-01
3060,Carmel Clay Schools,16390,16032,190,255,-65,103,-168,358,2,1,1,-1,2019-08-01
3070,Noblesville Schools,10971,10237,79,565,-486,169,-655,734,7,1,2,-6,2019-08-01
3115,Southern Hancock Co Com Sch Corp,3306,3109,507,156,351,41,310,197,6,15,1,9,2019-08-01
3125,Greenfield-Central Com Schools,4687,4231,222,399,-177,57,-234,456,10,5,1,-5,2019-08-01
3135,Mt Vernon Community School Corp,3820,3364,692,374,318,82,236,456,12,18,2,6,2019-08-01
3145,Eastern Hancock Co Com Sch Corp,992,896,286,94,192,2,190,96,10,29,0,19,2019-08-01
3160,Lanesville Community School Corp,553,450,309,92,217,11,206,103,19,56,2,37,2019-08-01
3180,North Harrison Com School Corp,2222,1961,196,250,-54,11,-65,261,12,9,0,-3,2019-08-01
3190,South Harrison Com Schools,3341,2873,102,390,-288,78,-366,468,14,3,2,-11,2019-08-01
3295,North West Hendricks Schools,1770,1653,176,93,83,24,59,117,7,10,1,3,2019-08-01
3305,Brownsburg Community School Corp,9375,8904,165,241,-76,230,-306,471,5,2,2,-3,2019-08-01
3315,Avon Community School Corp,10125,9432,193,505,-312,188,-500,693,7,2,2,-5,2019-08-01
3325,Danville Community School Corp,2573,2365,150,172,-22,36,-58,208,8,6,1,-2,2019-08-01
3330,Plainfield Community School Corp,5452,5119,366,262,104,71,33,333,6,7,1,1,2019-08-01
3335,Mill Creek Community Sch Corp,1530,1351,98,170,-72,9,-81,179,12,6,1,-5,2019-08-01
3405,Blue River Valley Schools,619,493,150,125,25,1,24,126,20,24,0,4,2019-08-01
3415,South Henry School Corp,647,514,228,127,101,6,95,133,21,35,1,15,2019-08-01
3435,Shenandoah School Corporation,1267,1139,245,120,125,8,117,128,10,19,1,9,2019-08-01
3445,New Castle Community School Corp,3322,2885,191,435,-244,2,-246,437,13,6,0,-7,2019-08-01
3455,C A Beard Memorial School Corp,1252,878,66,373,-307,1,-308,374,30,5,0,-25,2019-08-01
3460,Taylor Community School Corp,1352,878,354,464,-110,10,-120,474,35,26,1,-9,2019-08-01
3470,Northwestern School Corp,1413,1236,571,165,406,12,394,177,13,40,1,28,2019-08-01
3480,Eastern Howard School Corporation,1106,1026,494,80,414,0,414,80,7,45,0,37,2019-08-01
3490,Western School Corporation,2383,2069,617,290,327,24,303,314,13,26,1,13,2019-08-01
3500,Kokomo School Corporation,6801,5122,406,1536,-1130,143,-1273,1679,25,6,2,-19,2019-08-01
3625,Huntington Co Com Sch Corp,5468,4946,41,408,-367,114,-481,522,10,1,2,-9,2019-08-01
3640,Medora Community School Corp,208,125,22,81,-59,2,-61,83,40,11,1,-29,2019-08-01
3675,Seymour Community Schools,5234,4751,122,211,-89,272,-361,483,9,2,5,-7,2019-08-01
3695,Brownstown Cnt Com Sch Corp,1528,1404,184,97,87,27,60,124,8,12,2,4,2019-08-01
3710,Crothersville Community Schools,519,400,0,104,-104,15,-119,119,23,0,3,-23,2019-08-01
3785,Kankakee Valley School Corp,3556,3251,81,151,-70,154,-224,305,9,2,4,-6,2019-08-01
3815,Rensselaer Central School Corp,1559,1468,91,69,22,22,0,91,6,6,1,0,2019-08-01
3945,Jay School Corporation,3283,3033,83,202,-119,48,-167,250,8,3,1,-5,2019-08-01
3995,Madison Consolidated Schools,3059,2503,68,311,-243,245,-488,556,18,2,8,-16,2019-08-01
4000,Southwestern-Jefferson Co Con,1425,1224,61,147,-86,54,-140,201,14,4,4,-10,2019-08-01
4015,Jennings County School Corporation,4300,3946,111,251,-140,103,-243,354,8,3,2,-6,2019-08-01
4145,Clark-Pleasant Community Sch Corp,7250,6524,83,567,-484,159,-643,726,10,1,2,-9,2019-08-01
4205,Center Grove Community School Corp,8692,8036,325,444,-119,212,-331,656,8,4,2,-4,2019-08-01
4215,Edinburgh Community School Corp,792,658,134,118,16,16,0,134,17,17,2,0,2019-08-01
4225,Franklin Community School Corp,5152,4705,312,321,-9,126,-135,447,9,6,2,-3,2019-08-01
4245,Greenwood Community Sch Corp,3681,3319,648,247,401,115,286,362,10,18,3,8,2019-08-01
4255,Nineveh-Hensley-Jackson United,1757,1582,275,153,122,22,100,175,10,16,1,6,2019-08-01
4315,North Knox School Corp,1473,1295,7,157,-150,21,-171,178,12,0,1,-12,2019-08-01
4325,South Knox School Corp,1056,982,265,56,209,18,191,74,7,25,2,18,2019-08-01
4335,Vincennes Community School Corp,2956,2575,105,274,-169,107,-276,381,13,4,4,-9,2019-08-01
4345,Wawasee Community School Corp,2975,2735,183,226,-43,14,-57,240,8,6,0,-2,2019-08-01
4415,Warsaw Community Schools,7016,6530,352,336,16,150,-134,486,7,5,2,-2,2019-08-01
4445,Tippecanoe Valley School Corp,1881,1634,124,242,-118,5,-123,247,13,7,0,-7,2019-08-01
4455,Whitko Community School Corp,1539,1219,100,294,-194,26,-220,320,21,6,2,-14,2019-08-01
4515,Prairie Heights Community Sch Corp,1343,1168,128,172,-44,3,-47,175,13,10,0,-3,2019-08-01
4525,Westview School Corporation,2062,1959,253,95,158,8,150,103,5,12,0,7,2019-08-01
4535,Lakeland School Corporation,2065,1767,70,297,-227,1,-228,298,14,3,0,-11,2019-08-01
4580,Hanover Community School Corp,2507,2344,16,85,-69,78,-147,163,7,1,3,-6,2019-08-01
4590,River Forest Community Sch Corp,1413,1367,236,40,196,6,190,46,3,17,0,13,2019-08-01
4600,Merrillville Community School Corp,6955,6249,61,428,-367,278,-645,706,10,1,4,-9,2019-08-01
4615,Lake Central School Corporation,9637,9335,78,153,-75,149,-224,302,3,1,2,-2,2019-08-01
4645,Tri-Creek School Corporation,3333,3199,92,103,-11,31,-42,134,4,3,1,-1,2019-08-01
4650,Lake Ridge New Tech Schools,1887,1717,59,130,-71,40,-111,170,9,3,2,-6,2019-08-01
4660,Crown Point Community School Corp,8855,8568,0,154,-154,133,-287,287,3,0,2,-3,2019-08-01
4670,School City of East Chicago,5113,3594,89,1151,-1062,368,-1430,1519,30,2,7,-28,2019-08-01
4680,Lake Station Community Schools,1413,1138,57,211,-154,64,-218,275,19,4,5,-15,2019-08-01
4690,Gary Community School Corp,11782,4584,0,6638,-6638,560,-7198,7198,61,0,5,-61,2019-08-01
4700,Griffith Public Schools,2386,2220,123,113,10,53,-43,166,7,5,2,-2,2019-08-01
4710,School City of Hammond,14186,11907,509,1317,-808,962,-1770,2279,16,4,7,-12,2019-08-01
4720,School Town of Highland,3363,3192,59,86,-27,85,-112,171,5,2,3,-3,2019-08-01
4730,School City of Hobart,4174,3951,11,155,-144,68,-212,223,5,0,2,-5,2019-08-01
4740,School Town of Munster,3970,3914,186,27,159,29,130,56,1,5,1,3,2019-08-01
4760,School City of Whiting,924,831,346,67,279,26,253,93,10,37,3,27,2019-08-01
4805,New Prairie United School Corp,2566,2402,557,151,406,13,393,164,6,22,1,15,2019-08-01
4860,M S D of New Durham Township,782,637,228,138,90,7,83,145,19,29,1,11,2019-08-01
4915,Tri-Township Cons School Corp,490,284,76,204,-128,2,-130,206,42,16,0,-27,2019-08-01
4925,Michigan City Area Schools,6619,5431,0,800,-800,388,-1188,1188,18,0,6,-18,2019-08-01
4940,South Central Com School Corp,697,619,284,71,213,7,206,78,11,41,1,30,2019-08-01
4945,LaPorte Community School Corp,6351,5784,247,489,-242,78,-320,567,9,4,1,-5,2019-08-01
5075,North Lawrence Com Schools,4836,4503,124,263,-139,70,-209,333,7,3,1,-4,2019-08-01
5085,Mitchell Community Schools,1675,1493,31,179,-148,3,-151,182,11,2,0,-9,2019-08-01
5245,Frankton-Lapel Community Schools,2270,2191,834,65,769,14,755,79,3,37,1,33,2019-08-01
5255,South Madison Com Sch Corp,4100,3855,455,219,236,26,210,245,6,11,1,5,2019-08-01
5265,Alexandria Community School Corp,1507,1282,163,164,-1,61,-62,225,15,11,4,-4,2019-08-01
5275,Anderson Community School Corp,9980,6646,17,2619,-2602,715,-3317,3334,33,0,7,-33,2019-08-01
5280,Elwood Community School Corp,1561,1347,44,206,-162,8,-170,214,14,3,1,-11,2019-08-01
5300,M S D Decatur Township,7195,6332,315,653,-338,201,-539,854,12,4,3,-7,2019-08-01
5310,Franklin Township Com Sch Corp,10722,9539,105,692,-587,491,-1078,1183,11,1,5,-10,2019-08-01
5330,M S D Lawrence Township,16425,14289,1192,1401,-209,735,-944,2136,13,7,4,-6,2019-08-01
5340,Perry Township Schools,17804,15841,352,900,-548,1063,-1611,1963,11,2,6,-9,2019-08-01
5350,M S D Pike Township,12627,11085,0,958,-958,584,-1542,1542,12,0,5,-12,2019-08-01
5360,M S D Warren Township,14282,11724,0,1854,-1854,704,-2558,2558,18,0,5,-18,2019-08-01
5370,M S D Washington Township,11375,10159,814,674,140,542,-402,1216,11,7,5,-4,2019-08-01
5375,M S D Wayne Township,16691,15497,959,791,168,403,-235,1194,7,6,2,-1,2019-08-01
5380,Beech Grove City Schools,2214,1886,1078,198,880,130,750,328,15,49,6,34,2019-08-01
5385,Indianapolis Public Schools,46124,24713,665,17784,-17119,3627,-20746,21411,46,1,8,-45,2019-08-01
5400,School Town of Speedway,1998,1793,0,170,-170,35,-205,205,10,0,2,-10,2019-08-01
5455,Culver Community Schools Corp,927,664,92,252,-160,11,-171,263,28,10,1,-18,2019-08-01
5470,Argos Community Schools,645,494,110,145,-35,6,-41,151,23,17,1,-6,2019-08-01
5480,Bremen Public Schools,1335,1264,235,69,166,2,164,71,5,18,0,12,2019-08-01
5485,Plymouth Community School Corp,3380,3054,385,254,131,72,59,326,10,11,2,2,2019-08-01
5495,Triton School Corporation,859,771,129,87,42,1,41,88,10,15,0,5,2019-08-01
5520,Shoals Community School Corp,630,560,54,69,-15,1,-16,70,11,9,0,-3,2019-08-01
5525,Loogootee Community Sch Corp,864,712,109,152,-43,0,-43,152,18,13,0,-5,2019-08-01
5615,Maconaquah School Corp,2080,1789,269,280,-11,11,-22,291,14,13,1,-1,2019-08-01
5620,North Miami Community Schools,865,764,95,101,-6,0,-6,101,12,11,0,-1,2019-08-01
5625,Oak Hill United School Corp,1292,1204,473,73,400,15,385,88,7,37,1,30,2019-08-01
5635,Peru Community Schools,2070,1756,163,313,-150,1,-151,314,15,8,0,-7,2019-08-01
5705,Richland-Bean Blossom C S C,2708,2315,256,349,-93,44,-137,393,15,9,2,-5,2019-08-01
5740,Monroe County Community Sch Corp,11417,10463,288,732,-444,222,-666,954,8,3,2,-6,2019-08-01
5835,North Montgomery Com Sch Corp,1839,1638,138,195,-57,6,-63,201,11,8,0,-3,2019-08-01
5845,South Montgomery Com Sch Corp,1797,1573,89,219,-130,5,-135,224,12,5,0,-8,2019-08-01
5855,Crawfordsville Community Schools,2404,2196,248,208,40,0,40,208,9,10,0,2,2019-08-01
5900,Monroe-Gregg School District,1434,1265,234,130,104,38,66,168,12,16,3,5,2019-08-01
5910,Eminence Community School Corp,413,303,42,108,-66,2,-68,110,27,10,0,-16,2019-08-01
5925,M S D Martinsville Schools,4855,4211,95,464,-369,180,-549,644,13,2,4,-11,2019-08-01
5930,Mooresville Con School Corp,4152,3745,588,298,290,109,181,407,10,14,3,4,2019-08-01
5945,North Newton School Corp,1309,1190,23,104,-81,15,-96,119,9,2,1,-7,2019-08-01
5995,South Newton School Corp,847,793,23,52,-29,2,-31,54,6,3,0,-4,2019-08-01
6055,Central Noble Com School Corp,1203,1088,129,110,19,5,14,115,10,11,0,1,2019-08-01
6060,East Noble School Corporation,3696,3318,196,255,-59,123,-182,378,10,5,3,-5,2019-08-01
6065,West Noble School Corporation,2379,2164,100,210,-110,5,-115,215,9,4,0,-5,2019-08-01
6080,Rising Sun-Ohio Co Com,816,739,61,74,-13,3,-16,77,9,7,0,-2,2019-08-01
6145,Orleans Community Schools,783,717,128,66,62,0,62,66,8,16,0,8,2019-08-01
6155,Paoli Community School Corp,1424,1321,44,102,-58,1,-59,103,7,3,0,-4,2019-08-01
6160,Springs Valley Com School Corp,841,773,45,68,-23,0,-23,68,8,5,0,-3,2019-08-01
6195,Spencer-Owen Community Schools,2686,2275,83,386,-303,25,-328,411,15,3,1,-12,2019-08-01
6260,Southwest Parke Com Sch Corp,840,775,222,65,157,0,157,65,8,26,0,19,2019-08-01
6325,Perry Central Com Schools Corp,960,844,352,116,236,0,236,116,12,37,0,25,2019-08-01
6340,Cannelton City Schools,271,144,111,127,-16,0,-16,127,47,41,0,-6,2019-08-01
6350,Tell City-Troy Twp School Corp,1686,1262,122,424,-302,0,-302,424,25,7,0,-18,2019-08-01
6375,North Central Parke Comm Schl Corp,1204,1068,64,136,-72,0,-72,136,11,5,0,-6,2019-08-01
6445,Pike County School Corp,1852,1647,48,202,-154,3,-157,205,11,3,0,-8,2019-08-01
6460,M S D Boone Township,1038,982,156,46,110,10,100,56,5,15,1,10,2019-08-01
6470,Duneland School Corporation,5899,5439,334,422,-88,38,-126,460,8,6,1,-2,2019-08-01
6510,East Porter County School Corp,2374,2232,244,109,135,33,102,142,6,10,1,4,2019-08-01
6520,Porter Township School Corp,1384,1309,123,71,52,4,48,75,5,9,0,3,2019-08-01
6530,Union Township School Corp,1484,1404,46,73,-27,7,-34,80,5,3,0,-2,2019-08-01
6550,Portage Township Schools,8069,7343,32,561,-529,165,-694,726,9,0,2,-9,2019-08-01
6560,Valparaiso Community Schools,6701,6199,61,368,-307,134,-441,502,7,1,2,-7,2019-08-01
6590,M S D Mount Vernon,2067,1884,65,122,-57,61,-118,183,9,3,3,-6,2019-08-01
6600,M S D North Posey Co Schools,1418,1277,107,76,31,65,-34,141,10,8,5,-2,2019-08-01
6620,Eastern Pulaski Community Sch Corp,1051,996,190,55,135,0,135,55,5,18,0,13,2019-08-01
6630,West Central School Corp,744,690,63,50,13,4,9,54,7,8,1,1,2019-08-01
6705,South Putnam Community Schools,1073,931,133,142,-9,0,-9,142,13,12,0,-1,2019-08-01
6715,North Putnam Community Schools,1519,1308,37,210,-173,1,-174,211,14,2,0,-11,2019-08-01
6750,Cloverdale Community Schools,1080,981,94,98,-4,1,-5,99,9,9,0,-0,2019-08-01
6755,Greencastle Community School Corp,1844,1695,127,149,-22,0,-22,149,8,7,0,-1,2019-08-01
6795,Union School Corporation,363,164,2995,198,2797,1,2796,199,55,825,0,770,2019-08-01
6805,Randolph Southern School Corp,482,414,83,67,16,1,15,68,14,17,0,3,2019-08-01
6820,Monroe Central School Corp,950,856,214,94,120,0,120,94,10,23,0,13,2019-08-01
6825,Randolph Central School Corp,1430,1293,103,133,-30,4,-34,137,10,7,0,-2,2019-08-01
6835,Randolph Eastern School Corp,898,817,30,81,-51,0,-51,81,9,3,0,-6,2019-08-01
6865,South Ripley Com Sch Corp,1171,1025,100,126,-26,20,-46,146,12,9,2,-4,2019-08-01
6895,Batesville Community School Corp,2026,1866,265,73,192,87,105,160,8,13,4,5,2019-08-01
6900,Jac-Cen-Del Community Sch Corp,884,737,74,147,-73,0,-73,147,17,8,0,-8,2019-08-01
6910,Milan Community Schools,969,831,224,126,98,12,86,138,14,23,1,9,2019-08-01
6995,Rush County Schools,2218,1867,113,294,-181,57,-238,351,16,5,3,-11,2019-08-01
7150,John Glenn School Corporation,1643,1484,460,137,323,22,301,159,10,28,1,18,2019-08-01
7175,Penn-Harris-Madison School Corp,10230,9393,1710,549,1161,288,873,837,8,17,3,9,2019-08-01
7200,School City of Mishawaka,4685,3899,1191,550,641,236,405,786,17,25,5,9,2019-08-01
7205,South Bend Community School Corp,23333,16406,52,4338,-4286,2589,-6875,6927,30,0,11,-29,2019-08-01
7215,Union-North United School Corp,1133,849,392,277,115,7,108,284,25,35,1,10,2019-08-01
7230,Scott County School District 1,1329,1166,0,143,-143,20,-163,163,12,0,2,-12,2019-08-01
7255,Scott County School District 2,2498,2328,249,127,122,43,79,170,7,10,2,3,2019-08-01
7285,Shelby Eastern Schools,1266,973,130,280,-150,13,-163,293,23,10,1,-13,2019-08-01
7350,Northwestern Con School Corp,1277,1175,269,86,183,16,167,102,8,21,1,13,2019-08-01
7360,Southwestern Con Sch Shelby Co,617,498,91,115,-24,4,-28,119,19,15,1,-5,2019-08-01
7365,Shelbyville Central Schools,3952,3679,170,225,-55,48,-103,273,7,4,1,-3,2019-08-01
7385,North Spencer County Sch Corp,1979,1860,71,109,-38,10,-48,119,6,4,1,-2,2019-08-01
7445,South Spencer County Sch Corp,1237,1144,21,42,-21,51,-72,93,8,2,4,-6,2019-08-01
7495,Oregon-Davis School Corp,633,381,115,251,-136,1,-137,252,40,18,0,-22,2019-08-01
7515,North Judson-San Pierre Sch Corp,1246,951,38,237,-199,58,-257,295,24,3,5,-21,2019-08-01
7525,Knox Community School Corp,1765,1556,217,202,15,7,8,209,12,12,0,0,2019-08-01
7605,Fremont Community Schools,979,887,90,92,-2,0,-2,92,9,9,0,-0,2019-08-01
7610,Hamilton Community Schools,465,261,40,203,-163,1,-164,204,44,9,0,-35,2019-08-01
7615,M S D Steuben County,2648,2430,264,214,50,4,46,218,8,10,0,2,2019-08-01
7645,Northeast School Corp,1237,728,58,507,-449,2,-451,509,41,5,0,-36,2019-08-01
7715,Southwest School Corporation,1726,1503,193,223,-30,0,-30,223,13,11,0,-2,2019-08-01
7775,Switzerland County School Corp,1500,1393,39,95,-56,12,-68,107,7,3,1,-5,2019-08-01
7855,Lafayette School Corporation,8016,7336,313,227,86,453,-367,680,8,4,6,-5,2019-08-01
7865,Tippecanoe School Corp,14089,13009,213,683,-470,397,-867,1080,8,2,3,-6,2019-08-01
7875,West Lafayette Com School Corp,2289,2244,128,38,90,7,83,45,2,6,0,4,2019-08-01
7935,Tri-Central Community Schools,676,543,190,130,60,3,57,133,20,28,0,8,2019-08-01
7945,Tipton Community School Corp,1622,1436,85,186,-101,0,-101,186,11,5,0,-6,2019-08-01
7950,Union Co/Clg Corner Joint Sch Dist,1251,1199,87,52,35,0,35,52,4,7,0,3,2019-08-01
7995,Evansville Vanderburgh School Corp,24468,21737,121,1116,-995,1615,-2610,2731,11,0,7,-11,2019-08-01
8010,North Vermillion Com Sch Corp,713,666,87,45,42,2,40,47,7,12,0,6,2019-08-01
8020,South Vermillion Com Sch Corp,1750,1594,46,153,-107,3,-110,156,9,3,0,-6,2019-08-01
8030,Vigo County School Corp,14797,13991,80,650,-570,156,-726,806,5,1,1,-5,2019-08-01
8045,Manchester Community Schools,1503,1399,158,87,71,17,54,104,7,11,1,4,2019-08-01
8050,M S D Wabash County Schools,1834,1455,637,355,282,24,258,379,21,35,1,14,2019-08-01
8060,Wabash City Schools,1562,1195,323,351,-28,16,-44,367,23,21,1,-3,2019-08-01
8115,M S D Warren County,1382,1312,0,67,-67,3,-70,70,5,0,0,-5,2019-08-01
8130,Warrick County School Corp,10493,9906,185,351,-166,236,-402,587,6,2,2,-4,2019-08-01
8205,Salem Community Schools,1930,1660,148,268,-120,2,-122,270,14,8,0,-6,2019-08-01
8215,East Washington School Corp,1480,1273,96,206,-110,1,-111,207,14,6,0,-8,2019-08-01
8220,West Washington School Corp,783,673,188,109,79,1,78,110,14,24,0,10,2019-08-01
8305,Nettle Creek School Corporation,1001,883,214,114,100,4,96,118,12,21,0,10,2019-08-01
8355,Western Wayne Schools,905,781,77,120,-43,4,-47,124,14,9,0,-5,2019-08-01
8360,Centerville-Abington Com Schs,1452,1338,393,91,302,23,279,114,8,27,2,19,2019-08-01
8375,Northeastern Wayne Schools,943,866,425,68,357,9,348,77,8,45,1,37,2019-08-01
8385,Richmond Community Schools,5551,4417,120,875,-755,259,-1014,1134,20,2,5,-18,2019-08-01
8425,Southern Wells Com Schools,661,570,281,90,191,1,190,91,14,43,0,29,2019-08-01
8435,Northern Wells Community Schools,2399,2089,362,288,74,22,52,310,13,15,1,2,2019-08-01
8445,M S D Bluffton-Harrison,1501,1334,299,165,134,2,132,167,11,20,0,9,2019-08-01
8515,North White School Corp,1000,827,21,173,-152,0,-152,173,17,2,0,-15,2019-08-01
8525,Frontier School Corporation,649,569,83,76,7,4,3,80,12,13,1,0,2019-08-01
8535,Tri-County School Corporation,672,595,69,77,-8,0,-8,77,11,10,0,-1,2019-08-01
8565,Twin Lakes School Corp,2353,2239,128,103,25,11,14,114,5,5,0,1,2019-08-01
8625,Smith-Green Community Schools,1032,969,185,53,132,10,122,63,6,18,1,12,2019-08-01
8665,Whitley County Con Schools,3528,3315,151,156,-5,57,-62,213,6,4,2,-2,2019-08-01
0015,Adams Central Community Schools,1092,997,281,83,198,12,186,95,9,26,1,17,2018-08-01
0025,North Adams Community Schools,2093,1647,68,269,-201,177,-378,446,21,3,8,-18,2018-08-01
0035,South Adams Schools,1213,1124,76,86,-10,3,-13,89,7,6,0,-1,2018-08-01
0125,M S D Southwest Allen County Schls,7636,7280,60,113,-53,243,-296,356,5,1,3,-4,2018-08-01
0225,Northwest Allen County Schools,7973,7488,59,240,-181,245,-426,485,6,1,3,-5,2018-08-01
0235,Fort Wayne Community Schools,35199,28577,64,1902,-1838,4723,-6561,6625,19,0,13,-19,2018-08-01
0255,East Allen County Schools,10418,9062,617,353,264,1007,-743,1360,13,6,10,-7,2018-08-01
0365,Bartholomew Con School Corp,11779,10990,305,348,-43,442,-485,790,7,3,4,-4,2018-08-01
0370,Flat Rock-Hawcreek School Corp,870,776,108,84,24,10,14,94,11,12,1,2,2018-08-01
0395,Benton Community School Corp,1935,1795,36,81,-45,59,-104,140,7,2,3,-5,2018-08-01
0515,Blackford County Schools,1889,1636,29,252,-223,1,-224,253,13,2,0,-12,2018-08-01
0615,Western Boone Co Com Sch Dist,1637,1536,129,95,34,6,28,101,6,8,0,2,2018-08-01
0630,Zionsville Community Schools,6873,6756,36,80,-44,38,-82,118,2,1,1,-1,2018-08-01
0665,Lebanon Community School Corp,3699,3409,76,207,-131,85,-216,292,8,2,2,-6,2018-08-01
0670,Brown County School Corporation,2046,1847,33,173,-140,26,-166,199,10,2,1,-8,2018-08-01
0750,Carroll Consolidated School Corp,1072,995,86,70,16,7,9,77,7,8,1,1,2018-08-01
0755,Delphi Community School Corp,1527,1378,37,130,-93,19,-112,149,10,2,1,-7,2018-08-01
0775,Pioneer Regional School Corp,1005,913,44,92,-48,0,-48,92,9,4,0,-5,2018-08-01
0815,Lewis Cass Schools,1342,1124,187,214,-27,4,-31,218,16,14,0,-2,2018-08-01
0875,Logansport Community Sch Corp,4225,3980,180,248,-68,1,-69,249,6,4,0,-2,2018-08-01
0940,West Clark Community Schools,5023,4304,372,574,-202,146,-348,720,14,7,3,-7,2018-08-01
1000,Clarksville Community School Corp,1530,1111,259,341,-82,78,-160,419,27,17,5,-10,2018-08-01
1010,Greater Clark County Schools,11351,9887,229,1161,-932,305,-1237,1466,13,2,3,-11,2018-08-01
1125,Clay Community Schools,4095,3931,184,156,28,8,20,164,4,4,0,0,2018-08-01
1150,Clinton Central School Corporation,985,892,0,87,-87,6,-93,93,9,0,1,-9,2018-08-01
1160,Clinton Prairie School Corporation,1271,1204,3,52,-49,15,-64,67,5,0,1,-5,2018-08-01
1170,Community Schools of Frankfort,3123,3014,57,89,-32,22,-54,111,4,2,1,-2,2018-08-01
1180,Rossville Con School District,890,844,137,33,104,13,91,46,5,15,1,10,2018-08-01
1300,Crawford County Community Sch Corp,1595,1461,3,133,-130,1,-131,134,8,0,0,-8,2018-08-01
1315,Barr-Reeve Community Schools Inc,685,674,178,9,169,2,167,11,2,26,0,24,2018-08-01
1375,North Daviess Com Schools,1066,1033,177,29,148,4,144,33,3,17,0,14,2018-08-01
1405,Washington Community Schools,3046,2600,0,224,-224,222,-446,446,15,0,7,-15,2018-08-01
1560,Sunman-Dearborn Com Sch Corp,4077,3672,121,341,-220,64,-284,405,10,3,2,-7,2018-08-01
1600,South Dearborn Community Sch Corp,2747,2319,130,353,-223,75,-298,428,16,5,3,-11,2018-08-01
1620,Lawrenceburg Community School Corp,1798,1700,349,82,267,16,251,98,5,19,1,14,2018-08-01
1655,Decatur County Community Schools,1900,1736,247,136,111,28,83,164,9,13,1,4,2018-08-01
1730,Greensburg Community Schools,2393,2149,0,199,-199,45,-244,244,10,0,2,-10,2018-08-01
1805,DeKalb Co Eastern Com Sch Dist,1380,1248,99,102,-3,30,-33,132,10,7,2,-2,2018-08-01
1820,Garrett-Keyser-Butler Com Sch Corp,1745,1576,197,114,83,55,28,169,10,11,3,2,2018-08-01
1835,DeKalb Co Ctl United Sch Dist,3777,3314,179,338,-159,125,-284,463,12,5,3,-8,2018-08-01
1875,Delaware Community School Corp,2587,2340,326,241,85,6,79,247,10,13,0,3,2018-08-01
1885,Wes-Del Community Schools,797,675,198,114,84,8,76,122,15,25,1,10,2018-08-01
1895,Liberty-Perry Community Sch Corp,932,805,423,121,302,6,296,127,14,45,1,32,2018-08-01
1900,Cowan Community School Corp,600,514,300,82,218,4,214,86,14,50,1,36,2018-08-01
1910,Yorktown Community Schools,2430,2164,428,241,187,26,161,267,11,18,1,7,2018-08-01
1940,Daleville Community Schools,616,520,428,87,341,9,332,96,16,69,1,54,2018-08-01
1970,Muncie Community Schools,7251,4961,179,2117,-1938,175,-2113,2292,32,2,2,-29,2018-08-01
2040,Northeast Dubois Co Sch Corp,816,777,56,39,17,1,16,40,5,7,0,2,2018-08-01
2100,Southeast Dubois Co Sch Corp,1211,1170,108,40,68,2,66,42,3,9,0,5,2018-08-01
2110,Southwest Dubois Co Sch Corp,1760,1677,50,81,-31,3,-34,84,5,3,0,-2,2018-08-01
2120,Greater Jasper Consolidated Schs,3169,3007,121,73,48,90,-42,163,5,4,3,-1,2018-08-01
2155,Fairfield Community Schools,2084,1938,206,112,94,34,60,146,7,10,2,3,2018-08-01
2260,Baugo Community Schools,1789,1653,206,113,93,23,70,136,8,12,1,4,2018-08-01
2270,Concord Community Schools,4888,4493,776,314,462,81,381,395,8,16,2,8,2018-08-01
2275,Middlebury Community Schools,4446,4144,409,196,213,106,107,302,7,9,2,2,2018-08-01
2285,Wa-Nee Community Schools,2971,2840,165,95,70,36,34,131,4,6,1,1,2018-08-01
2305,Elkhart Community Schools,14177,12286,282,1487,-1205,405,-1610,1892,13,2,3,-11,2018-08-01
2315,Goshen Community Schools,7026,6343,260,428,-168,255,-423,683,10,4,4,-6,2018-08-01
2395,Fayette County School Corporation,3528,3248,44,197,-153,84,-237,281,8,1,2,-7,2018-08-01
2400,New Albany-Floyd Co Con Sch,11756,10670,780,784,-4,302,-306,1086,9,7,3,-3,2018-08-01
2435,Attica Consolidated School Corp,638,590,27,39,-12,9,-21,48,8,4,1,-3,2018-08-01
2440,Covington Community School Corp,897,831,73,47,26,19,7,66,7,8,2,1,2018-08-01
2455,Southeast Fountain School Corp,1049,968,56,77,-21,5,-26,82,8,5,0,-2,2018-08-01
2475,Franklin County Community Sch Corp,2562,2301,19,214,-195,48,-243,262,10,1,2,-9,2018-08-01
2645,Rochester Community School Corp,1827,1633,127,188,-61,6,-67,194,11,7,0,-4,2018-08-01
2650,Caston School Corporation,678,567,105,109,-4,2,-6,111,16,15,0,-1,2018-08-01
2725,East Gibson School Corporation,1008,843,12,153,-141,12,-153,165,16,1,1,-15,2018-08-01
2735,North Gibson School Corporation,2178,1952,61,168,-107,58,-165,226,10,3,3,-8,2018-08-01
2765,South Gibson School Corporation,1921,1758,266,89,177,74,103,163,8,14,4,5,2018-08-01
2815,Eastbrook Community Sch Corp,1439,1323,287,87,200,29,171,116,8,20,2,12,2018-08-01
2825,Madison-Grant United School Corp,1271,1112,45,122,-77,37,-114,159,13,4,3,-9,2018-08-01
2855,Mississinewa Community School Corp,1904,1763,617,110,507,32,475,142,7,32,2,25,2018-08-01
2865,Marion Community Schools,5060,3449,29,1332,-1303,279,-1582,1611,32,1,6,-31,2018-08-01
2920,Bloomfield School District,905,797,62,106,-44,2,-46,108,12,7,0,-5,2018-08-01
2940,Eastern Greene Schools,1182,1055,84,104,-20,23,-43,127,11,7,2,-4,2018-08-01
2950,Linton-Stockton School Corporation,1307,1178,236,129,107,0,107,129,10,18,0,8,2018-08-01
2960,M S D Shakamak Schools,830,727,39,103,-64,0,-64,103,12,5,0,-8,2018-08-01
2980,White River Valley School District,933,743,20,190,-170,0,-170,190,20,2,0,-18,2018-08-01
3005,Hamilton Southeastern Schools,22179,21321,26,598,-572,284,-856,882,4,0,1,-4,2018-08-01
3025,Hamilton Heights School Corp,2171,2073,202,78,124,22,102,100,5,9,1,5,2018-08-01
3030,Westfield-Washington Schools,7993,7749,83,184,-101,63,-164,247,3,1,1,-2,2018-08-01
3055,Sheridan Community Schools,1063,988,88,70,18,5,13,75,7,8,0,1,2018-08-01
3060,Carmel Clay Schools,16214,15887,146,260,-114,86,-200,346,2,1,1,-1,2018-08-01
3070,Noblesville Schools,11017,10370,40,519,-479,154,-633,673,6,0,1,-6,2018-08-01
3115,Southern Hancock Co Com Sch Corp,3222,3064,520,129,391,30,361,159,5,16,1,11,2018-08-01
3125,Greenfield-Central Com Schools,4791,4358,168,371,-203,62,-265,433,9,4,1,-6,2018-08-01
3135,Mt Vernon Community School Corp,3781,3355,627,352,275,82,193,434,11,17,2,5,2018-08-01
3145,Eastern Hancock Co Com Sch Corp,1016,951,264,63,201,3,198,66,6,26,0,19,2018-08-01
3160,Lanesville Community School Corp,551,453,316,81,235,17,218,98,18,57,3,40,2018-08-01
3180,North Harrison Com School Corp,2270,2039,157,218,-61,13,-74,231,10,7,1,-3,2018-08-01
3190,South Harrison Com Schools,3353,2925,93,364,-271,64,-335,428,13,3,2,-10,2018-08-01
3295,North West Hendricks Schools,1832,1719,180,84,96,30,66,114,6,10,2,4,2018-08-01
3305,Brownsburg Community School Corp,9079,8626,141,230,-89,227,-316,457,5,2,3,-3,2018-08-01
3315,Avon Community School Corp,9971,9290,151,504,-353,182,-535,686,7,2,2,-5,2018-08-01
3325,Danville Community School Corp,2526,2328,143,159,-16,41,-57,200,8,6,2,-2,2018-08-01
3330,Plainfield Community School Corp,5305,5045,367,208,159,54,105,262,5,7,1,2,2018-08-01
3335,Mill Creek Community Sch Corp,1589,1435,83,149,-66,6,-72,155,10,5,0,-5,2018-08-01
3405,Blue River Valley Schools,634,510,140,121,19,3,16,124,20,22,0,3,2018-08-01
3415,South Henry School Corp,660,559,251,97,154,4,150,101,15,38,1,23,2018-08-01
3435,Shenandoah School Corporation,1291,1174,222,108,114,10,104,118,9,17,1,8,2018-08-01
3445,New Castle Community School Corp,3430,3009,127,418,-291,3,-294,421,12,4,0,-9,2018-08-01
3455,C A Beard Memorial School Corp,1321,1022,61,300,-239,0,-239,300,23,5,0,-18,2018-08-01
3460,Taylor Community School Corp,1420,953,307,451,-144,16,-160,467,33,22,1,-11,2018-08-01
3470,Northwestern School Corp,1457,1284,535,158,377,15,362,173,12,37,1,25,2018-08-01
3480,Eastern Howard School Corporation,1104,1041,464,61,403,2,401,63,6,42,0,36,2018-08-01
3490,Western School Corporation,2350,2073,593,257,336,20,316,277,12,25,1,13,2018-08-01
3500,Kokomo School Corporation,6873,5284,430,1415,-985,177,-1162,1592,23,6,3,-17,2018-08-01
3625,Huntington Co Com Sch Corp,5502,5052,43,332,-289,118,-407,450,8,1,2,-7,2018-08-01
3640,Medora Community School Corp,203,152,23,50,-27,1,-28,51,25,11,0,-14,2018-08-01
3675,Seymour Community Schools,5041,4596,69,175,-106,271,-377,446,9,1,5,-7,2018-08-01
3695,Brownstown Cnt Com Sch Corp,1554,1467,129,71,58,16,42,87,6,8,1,3,2018-08-01
3710,Crothersville Community Schools,515,441,0,58,-58,16,-74,74,14,0,3,-14,2018-08-01
3785,Kankakee Valley School Corp,3560,3291,78,115,-37,154,-191,269,8,2,4,-5,2018-08-01
3815,Rensselaer Central School Corp,1575,1482,83,69,14,25,-11,94,6,5,2,-1,2018-08-01
3945,Jay School Corporation,3443,3250,14,144,-130,49,-179,193,6,0,1,-5,2018-08-01
3995,Madison Consolidated Schools,3089,2570,92,283,-191,237,-428,520,17,3,8,-14,2018-08-01
4000,Southwestern-Jefferson Co Con,1474,1278,55,144,-89,52,-141,196,13,4,4,-10,2018-08-01
4015,Jennings County School Corporation,4394,4066,112,235,-123,93,-216,328,7,3,2,-5,2018-08-01
4145,Clark-Pleasant Community Sch Corp,7115,6479,65,477,-412,165,-577,642,9,1,2,-8,2018-08-01
4205,Center Grove Community School Corp,8643,7991,284,425,-141,229,-370,654,8,3,3,-4,2018-08-01
4215,Edinburgh Community School Corp,813,695,122,104,18,14,4,118,15,15,2,0,2018-08-01
4225,Franklin Community School Corp,5208,4774,328,294,34,141,-107,435,8,6,3,-2,2018-08-01
4245,Greenwood Community Sch Corp,3787,3436,568,239,329,112,217,351,9,15,3,6,2018-08-01
4255,Nineveh-Hensley-Jackson United,1725,1555,278,148,130,22,108,170,10,16,1,6,2018-08-01
4315,North Knox School Corp,1514,1333,5,164,-159,17,-176,181,12,0,1,-12,2018-08-01
4325,South Knox School Corp,1058,989,257,55,202,14,188,69,7,24,1,18,2018-08-01
4335,Vincennes Community School Corp,2966,2593,114,270,-156,104,-260,374,13,4,4,-9,2018-08-01
4345,Wawasee Community School Corp,3107,2898,107,195,-88,16,-104,211,7,3,1,-3,2018-08-01
4415,Warsaw Community Schools,7119,6663,304,284,20,175,-155,459,6,4,2,-2,2018-08-01
4445,Tippecanoe Valley School Corp,1922,1719,126,196,-70,7,-77,203,11,7,0,-4,2018-08-01
4455,Whitko Community School Corp,1557,1265,83,256,-173,36,-209,292,19,5,2,-13,2018-08-01
4515,Prairie Heights Community Sch Corp,1339,1194,91,142,-51,3,-54,145,11,7,0,-4,2018-08-01
4525,Westview School Corporation,2102,2017,204,80,124,5,119,85,4,10,0,6,2018-08-01
4535,Lakeland School Corporation,2084,1846,65,240,-175,4,-179,244,12,3,0,-9,2018-08-01
4580,Hanover Community School Corp,2389,2244,18,78,-60,67,-127,145,6,1,3,-5,2018-08-01
4590,River Forest Community Sch Corp,1486,1443,194,40,154,3,151,43,3,13,0,10,2018-08-01
4600,Merrillville Community School Corp,7040,6313,67,457,-390,270,-660,727,10,1,4,-9,2018-08-01
4615,Lake Central School Corporation,9634,9363,66,134,-68,138,-206,272,3,1,1,-2,2018-08-01
4645,Tri-Creek School Corporation,3345,3217,71,92,-21,36,-57,128,4,2,1,-2,2018-08-01
4650,Lake Ridge New Tech Schools,1949,1792,69,128,-59,30,-89,158,8,4,2,-5,2018-08-01
4660,Crown Point Community School Corp,8732,8449,1,148,-147,135,-282,283,3,0,2,-3,2018-08-01
4670,School City of East Chicago,5359,3721,0,1272,-1272,367,-1639,1639,31,0,7,-31,2018-08-01
4680,Lake Station Community Schools,1408,1152,64,190,-126,67,-193,257,18,5,5,-14,2018-08-01
4690,Gary Community School Corp,12032,4681,0,6776,-6776,578,-7354,7354,61,0,5,-61,2018-08-01
4700,Griffith Public Schools,2474,2293,127,110,17,71,-54,181,7,5,3,-2,2018-08-01
4710,School City of Hammond,14521,12416,671,1183,-512,926,-1438,2109,15,5,6,-10,2018-08-01
4720,School Town of Highland,3334,3183,41,77,-36,74,-110,151,5,1,2,-3,2018-08-01
4730,School City of Hobart,4192,3957,29,155,-126,83,-209,238,6,1,2,-5,2018-08-01
4740,School Town of Munster,3870,3798,181,42,139,30,109,72,2,5,1,3,2018-08-01
4760,School City of Whiting,943,836,303,73,230,34,196,107,11,32,4,21,2018-08-01
4805,New Prairie United School Corp,2548,2394,559,148,411,6,405,154,6,22,0,16,2018-08-01
4860,M S D of New Durham Township,803,681,213,119,94,3,91,122,15,27,0,11,2018-08-01
4915,Tri-Township Cons School Corp,524,288,72,233,-161,3,-164,236,45,14,1,-31,2018-08-01
4925,Michigan City Area Schools,6699,5444,0,822,-822,434,-1256,1256,19,0,6,-19,2018-08-01
4940,South Central Com School Corp,702,627,279,72,207,3,204,75,11,40,0,29,2018-08-01
4945,LaPorte Community School Corp,6470,5902,244,471,-227,97,-324,568,9,4,1,-5,2018-08-01
5075,North Lawrence Com Schools,5038,4750,105,218,-113,71,-184,289,6,2,1,-4,2018-08-01
5085,Mitchell Community Schools,1719,1555,24,163,-139,1,-140,164,10,1,0,-8,2018-08-01
5245,Frankton-Lapel Community Schools,2258,2178,853,67,786,16,770,83,4,38,1,34,2018-08-01
5255,South Madison Com Sch Corp,4293,4037,429,230,199,31,168,261,6,10,1,4,2018-08-01
5265,Alexandria Community School Corp,1573,1359,150,161,-11,54,-65,215,14,10,3,-4,2018-08-01
5275,Anderson Community School Corp,9968,6740,24,2517,-2493,717,-3210,3234,32,0,7,-32,2018-08-01
5280,Elwood Community School Corp,1677,1443,30,225,-195,9,-204,234,14,2,1,-12,2018-08-01
5300,M S D Decatur Township,7137,6364,312,588,-276,181,-457,769,11,4,3,-6,2018-08-01
5310,Franklin Township Com Sch Corp,10299,9187,103,661,-558,460,-1018,1121,11,1,4,-10,2018-08-01
5330,M S D Lawrence Township,16662,14634,1126,1318,-192,736,-928,2054,12,7,4,-6,2018-08-01
5340,Perry Township Schools,17647,15875,378,868,-490,922,-1412,1790,10,2,5,-8,2018-08-01
5350,M S D Pike Township,12835,11192,0,1066,-1066,582,-1648,1648,13,0,5,-13,2018-08-01
5360,M S D Warren Township,14492,12008,0,1810,-1810,692,-2502,2502,17,0,5,-17,2018-08-01
5370,M S D Washington Township,11614,10392,846,708,138,526,-388,1234,11,7,5,-3,2018-08-01
5375,M S D Wayne Township,16609,15438,905,762,143,416,-273,1178,7,5,3,-2,2018-08-01
5380,Beech Grove City Schools,2322,2014,1134,202,932,109,823,311,13,49,5,35,2018-08-01
5385,Indianapolis Public Schools,46972,26215,714,17156,-16442,3659,-20101,20815,44,2,8,-43,2018-08-01
5400,School Town of Speedway,2077,1841,0,194,-194,43,-237,237,11,0,2,-11,2018-08-01
5455,Culver Community Schools Corp,930,661,86,262,-176,7,-183,269,29,9,1,-20,2018-08-01
5470,Argos Community Schools,649,501,106,142,-36,6,-42,148,23,16,1,-6,2018-08-01
5480,Bremen Public Schools,1331,1259,228,69,159,3,156,72,5,17,0,12,2018-08-01
5485,Plymouth Community School Corp,3392,3103,392,210,182,79,103,289,9,12,2,3,2018-08-01
5495,Triton School Corporation,902,797,99,101,-2,4,-6,105,12,11,0,-1,2018-08-01
5520,Shoals Community School Corp,556,525,47,29,18,2,16,31,6,8,0,3,2018-08-01
5525,Loogootee Community Sch Corp,974,818,0,155,-155,1,-156,156,16,0,0,-16,2018-08-01
5615,Maconaquah School Corp,2227,1932,244,287,-43,8,-51,295,13,11,0,-2,2018-08-01
5620,North Miami Community Schools,890,788,106,103,3,0,3,103,12,12,0,0,2018-08-01
5625,Oak Hill United School Corp,1320,1242,471,58,413,20,393,78,6,36,2,30,2018-08-01
5635,Peru Community Schools,2190,1873,157,317,-160,0,-160,317,14,7,0,-7,2018-08-01
5705,Richland-Bean Blossom C S C,2800,2487,239,282,-43,31,-74,313,11,9,1,-3,2018-08-01
5740,Monroe County Community Sch Corp,11401,10543,223,663,-440,196,-636,859,8,2,2,-6,2018-08-01
5835,North Montgomery Com Sch Corp,1895,1736,120,150,-30,9,-39,159,8,6,0,-2,2018-08-01
5845,South Montgomery Com Sch Corp,1850,1623,2,222,-220,5,-225,227,12,0,0,-12,2018-08-01
5855,Crawfordsville Community Schools,2353,2234,211,115,96,4,92,119,5,9,0,4,2018-08-01
5900,Monroe-Gregg School District,1429,1265,222,120,102,44,58,164,11,16,3,4,2018-08-01
5910,Eminence Community School Corp,409,306,50,100,-50,3,-53,103,25,12,1,-13,2018-08-01
5925,M S D Martinsville Schools,4971,4399,86,406,-320,169,-489,575,12,2,3,-10,2018-08-01
5930,Mooresville Con School Corp,4215,3824,510,284,226,109,117,393,9,12,3,3,2018-08-01
5945,North Newton School Corp,1440,1334,25,96,-71,10,-81,106,7,2,1,-6,2018-08-01
5995,South Newton School Corp,895,845,23,48,-25,2,-27,50,6,3,0,-3,2018-08-01
6055,Central Noble Com School Corp,1233,1098,99,118,-19,17,-36,135,11,8,1,-3,2018-08-01
6060,East Noble School Corporation,3791,3422,197,244,-47,126,-173,370,10,5,3,-5,2018-08-01
6065,West Noble School Corporation,2417,2258,115,157,-42,2,-44,159,7,5,0,-2,2018-08-01
6080,Rising Sun-Ohio Co Com,823,744,52,75,-23,4,-27,79,10,6,0,-3,2018-08-01
6145,Orleans Community Schools,735,696,125,39,86,0,86,39,5,17,0,12,2018-08-01
6155,Paoli Community School Corp,1476,1390,26,86,-60,0,-60,86,6,2,0,-4,2018-08-01
6160,Springs Valley Com School Corp,898,835,23,63,-40,0,-40,63,7,3,0,-4,2018-08-01
6195,Spencer-Owen Community Schools,2732,2378,85,322,-237,33,-270,355,13,3,1,-10,2018-08-01
6260,Southwest Parke Com Sch Corp,872,803,193,69,124,0,124,69,8,22,0,14,2018-08-01
6325,Perry Central Com Schools Corp,921,842,343,78,265,1,264,79,9,37,0,29,2018-08-01
6340,Cannelton City Schools,277,142,101,134,-33,1,-34,135,49,36,0,-12,2018-08-01
6350,Tell City-Troy Twp School Corp,1678,1278,145,400,-255,0,-255,400,24,9,0,-15,2018-08-01
6375,North Central Parke Comm Schl Corp,1236,1119,73,117,-44,0,-44,117,9,6,0,-4,2018-08-01
6445,Pike County School Corp,1880,1703,49,174,-125,3,-128,177,9,3,0,-7,2018-08-01
6460,M S D Boone Township,1040,977,150,54,96,9,87,63,6,14,1,8,2018-08-01
6470,Duneland School Corporation,6016,5543,276,434,-158,40,-198,474,8,5,1,-3,2018-08-01
6510,East Porter County School Corp,2405,2278,254,100,154,27,127,127,5,11,1,5,2018-08-01
6520,Porter Township School Corp,1363,1289,107,64,43,10,33,74,5,8,1,2,2018-08-01
6530,Union Township School Corp,1483,1417,21,62,-41,4,-45,66,4,1,0,-3,2018-08-01
6550,Portage Township Schools,8191,7579,29,447,-418,165,-583,612,7,0,2,-7,2018-08-01
6560,Valparaiso Community Schools,6612,6177,140,348,-208,87,-295,435,7,2,1,-4,2018-08-01
6590,M S D Mount Vernon,2147,1970,61,115,-54,62,-116,177,8,3,3,-5,2018-08-01
6600,M S D North Posey Co Schools,1447,1322,81,75,6,50,-44,125,9,6,3,-3,2018-08-01
6620,Eastern Pulaski Community Sch Corp,1110,1060,220,50,170,0,170,50,5,20,0,15,2018-08-01
6630,West Central School Corp,780,719,57,59,-2,2,-4,61,8,7,0,-1,2018-08-01
6705,South Putnam Community Schools,1144,994,126,148,-22,2,-24,150,13,11,0,-2,2018-08-01
6715,North Putnam Community Schools,1531,1336,33,195,-162,1,-163,196,13,2,0,-11,2018-08-01
6750,Cloverdale Community Schools,1127,1026,83,101,-18,0,-18,101,9,7,0,-2,2018-08-01
6755,Greencastle Community School Corp,1857,1732,129,125,4,0,4,125,7,7,0,0,2018-08-01
6795,Union School Corporation,367,173,631,193,438,1,437,194,53,172,0,119,2018-08-01
6805,Randolph Southern School Corp,532,471,71,60,11,2,9,62,12,13,0,2,2018-08-01
6820,Monroe Central School Corp,963,865,194,97,97,1,96,98,10,20,0,10,2018-08-01
6825,Randolph Central School Corp,1475,1371,103,103,0,1,-1,104,7,7,0,-0,2018-08-01
6835,Randolph Eastern School Corp,915,840,30,75,-45,0,-45,75,8,3,0,-5,2018-08-01
6865,South Ripley Com Sch Corp,1231,1089,104,124,-20,18,-38,142,12,8,1,-3,2018-08-01
6895,Batesville Community School Corp,2097,1955,244,50,194,92,102,142,7,12,4,5,2018-08-01
6900,Jac-Cen-Del Community Sch Corp,894,747,83,147,-64,0,-64,147,16,9,0,-7,2018-08-01
6910,Milan Community Schools,1062,945,213,109,104,8,96,117,11,20,1,9,2018-08-01
6995,Rush County Schools,2292,1965,104,270,-166,57,-223,327,14,5,2,-10,2018-08-01
7150,John Glenn School Corporation,1669,1506,414,137,277,26,251,163,10,25,2,15,2018-08-01
7175,Penn-Harris-Madison School Corp,10140,9465,1680,377,1303,299,1004,676,7,17,3,10,2018-08-01
7200,School City of Mishawaka,5458,4672,511,499,12,288,-276,787,14,9,5,-5,2018-08-01
7205,South Bend Community School Corp,23332,16733,67,3975,-3908,2627,-6535,6602,28,0,11,-28,2018-08-01
7215,Union-North United School Corp,1145,851,329,282,47,12,35,294,26,29,1,3,2018-08-01
7230,Scott County School District 1,1333,1195,3,119,-116,20,-136,139,10,0,2,-10,2018-08-01
7255,Scott County School District 2,2653,2509,143,102,41,42,-1,144,5,5,2,-0,2018-08-01
7285,Shelby Eastern Schools,1277,1010,124,266,-142,1,-143,267,21,10,0,-11,2018-08-01
7350,Northwestern Con School Corp,1318,1224,236,82,154,13,141,95,7,18,1,11,2018-08-01
7360,Southwestern Con Sch Shelby Co,619,507,77,106,-29,6,-35,112,18,12,1,-6,2018-08-01
7365,Shelbyville Central Schools,3920,3669,159,197,-38,54,-92,251,6,4,1,-2,2018-08-01
7385,North Spencer County Sch Corp,1998,1870,45,114,-69,14,-83,128,6,2,1,-4,2018-08-01
7445,South Spencer County Sch Corp,1273,1185,31,29,2,59,-57,88,7,2,5,-4,2018-08-01
7495,Oregon-Davis School Corp,660,411,140,246,-106,3,-109,249,38,21,0,-17,2018-08-01
7515,North Judson-San Pierre Sch Corp,1259,987,35,220,-185,53,-238,273,22,3,4,-19,2018-08-01
7525,Knox Community School Corp,1837,1628,220,206,14,3,11,209,11,12,0,1,2018-08-01
7605,Fremont Community Schools,1030,944,3,83,-80,3,-83,86,8,0,0,-8,2018-08-01
7610,Hamilton Community Schools,417,245,39,168,-129,4,-133,172,41,9,1,-32,2018-08-01
7615,M S D Steuben County,2641,2502,255,136,119,5,114,141,5,10,0,4,2018-08-01
7645,Northeast School Corp,1300,794,44,505,-461,2,-463,507,39,3,0,-36,2018-08-01
7715,Southwest School Corporation,1760,1527,186,233,-47,0,-47,233,13,11,0,-3,2018-08-01
7775,Switzerland County School Corp,1525,1436,23,86,-63,5,-68,91,6,2,0,-4,2018-08-01
7855,Lafayette School Corporation,8048,7363,307,228,79,458,-379,686,9,4,6,-5,2018-08-01
7865,Tippecanoe School Corp,14045,13010,226,651,-425,386,-811,1037,7,2,3,-6,2018-08-01
7875,West Lafayette Com School Corp,2280,2239,136,27,109,14,95,41,2,6,1,4,2018-08-01
7935,Tri-Central Community Schools,676,566,176,110,66,0,66,110,16,26,0,10,2018-08-01
7945,Tipton Community School Corp,1637,1448,94,189,-95,1,-96,190,12,6,0,-6,2018-08-01
7950,Union Co/Clg Corner Joint Sch Dist,1327,1278,77,49,28,0,28,49,4,6,0,2,2018-08-01
7995,Evansville Vanderburgh School Corp,24660,22036,142,1037,-895,1589,-2484,2626,11,1,6,-10,2018-08-01
8010,North Vermillion Com Sch Corp,729,684,74,45,29,0,29,45,6,10,0,4,2018-08-01
8020,South Vermillion Com Sch Corp,1829,1668,45,161,-116,0,-116,161,9,2,0,-6,2018-08-01
8030,Vigo County School Corp,15119,14369,105,587,-482,164,-646,751,5,1,1,-4,2018-08-01
8045,Manchester Community Schools,1529,1431,152,79,73,20,53,99,6,10,1,3,2018-08-01
8050,M S D Wabash County Schools,1971,1599,534,346,188,26,162,372,19,27,1,8,2018-08-01
8060,Wabash City Schools,1527,1199,304,313,-9,15,-24,328,21,20,1,-2,2018-08-01
8115,M S D Warren County,1380,1323,0,56,-56,1,-57,57,4,0,0,-4,2018-08-01
8130,Warrick County School Corp,10560,10030,167,306,-139,225,-364,531,5,2,2,-3,2018-08-01
8205,Salem Community Schools,1950,1747,157,201,-44,2,-46,203,10,8,0,-2,2018-08-01
8215,East Washington School Corp,1518,1332,85,184,-99,2,-101,186,12,6,0,-7,2018-08-01
8220,West Washington School Corp,767,653,138,113,25,1,24,114,15,18,0,3,2018-08-01
8305,Nettle Creek School Corporation,992,901,172,88,84,3,81,91,9,17,0,8,2018-08-01
8355,Western Wayne Schools,970,876,77,88,-11,6,-17,94,10,8,1,-2,2018-08-01
8360,Centerville-Abington Com Schs,1473,1384,347,66,281,23,258,89,6,24,2,18,2018-08-01
8375,Northeastern Wayne Schools,964,906,359,50,309,8,301,58,6,37,1,31,2018-08-01
8385,Richmond Community Schools,5609,4604,87,761,-674,247,-921,1008,18,2,4,-16,2018-08-01
8425,Southern Wells Com Schools,657,576,301,79,222,2,220,81,12,46,0,33,2018-08-01
8435,Northern Wells Community Schools,2408,2110,343,269,74,29,45,298,12,14,1,2,2018-08-01
8445,M S D Bluffton-Harrison,1470,1327,276,141,135,2,133,143,10,19,0,9,2018-08-01
8515,North White School Corp,1017,852,18,163,-145,2,-147,165,16,2,0,-14,2018-08-01
8525,Frontier School Corporation,667,601,69,61,8,5,3,66,10,10,1,0,2018-08-01
8535,Tri-County School Corporation,738,679,57,56,1,5,-4,61,8,8,1,-1,2018-08-01
8565,Twin Lakes School Corp,2370,2264,136,95,41,12,29,107,5,6,1,1,2018-08-01
8625,Smith-Green Community Schools,1057,1006,174,40,134,11,123,51,5,16,1,12,2018-08-01
8665,Whitley County Con Schools,3596,3398,139,145,-6,54,-60,199,6,4,2,-2,2018-08-01
